Id,Therapy Hours,Initial Health Score,Lifestyle Activities,Average Sleep Hours,Follow-Up Sessions,Therapy_x_Health,Therapy_plus_Health,Sleep_x_Health,FollowUp_x_Health,Therapy_x_Sleep,Sleep_plus_Health,Therapy_Health_ratio,Sleep_Health_ratio,log_Therapy,log_Health
6253,5,69,No,8,2,345,74,552,138,40,77,0.07142857142857142,0.11428571428571428,1.791759469228055,4.248495242049359
4685,2,46,Yes,4,8,92,48,184,368,8,50,0.0425531914893617,0.0851063829787234,1.0986122886681098,3.8501476017100584
1732,7,56,Yes,7,5,392,63,392,280,49,63,0.12280701754385964,0.12280701754385964,2.0794415416798357,4.04305126783455
4743,6,42,Yes,8,5,252,48,336,210,48,50,0.13953488372093023,0.18604651162790697,1.9459101490553132,3.7612001156935624
4522,7,53,No,4,6,371,60,212,318,28,57,0.12962962962962962,0.07407407407407407,2.0794415416798357,3.9889840465642745
6341,9,63,No,4,7,567,72,252,441,36,67,0.140625,0.0625,2.302585092994046,4.1588830833596715
577,6,59,Yes,4,1,354,65,236,59,24,63,0.1,0.06666666666666667,1.9459101490553132,4.0943445622221
5203,6,96,No,9,7,576,102,864,672,54,105,0.061855670103092786,0.09278350515463918,1.9459101490553132,4.574710978503383
6364,7,46,No,7,8,322,53,322,368,49,53,0.14893617021276595,0.14893617021276595,2.0794415416798357,3.8501476017100584
440,7,79,Yes,9,4,553,86,711,316,63,88,0.0875,0.1125,2.0794415416798357,4.382026634673881
2751,4,80,Yes,7,4,320,84,560,320,28,87,0.04938271604938271,0.08641975308641975,1.6094379124341003,4.394449154672439
7488,2,49,Yes,4,4,98,51,196,196,8,53,0.04,0.08,1.0986122886681098,3.912023005428146
5273,9,66,No,4,0,594,75,264,0,36,70,0.13432835820895522,0.05970149253731343,2.302585092994046,4.204692619390966
5654,6,56,Yes,6,2,336,62,336,112,36,62,0.10526315789473684,0.10526315789473684,1.9459101490553132,4.04305126783455
4000,8,54,Yes,8,4,432,62,432,216,64,62,0.14545454545454545,0.14545454545454545,2.1972245773362196,4.007333185232471
6034,1,72,No,4,3,72,73,288,216,4,76,0.0136986301369863,0.0547945205479452,0.6931471805599453,4.290459441148391
583,1,83,No,7,7,83,84,581,581,7,90,0.011904761904761904,0.08333333333333333,0.6931471805599453,4.430816798843313
9931,8,85,Yes,4,6,680,93,340,510,32,89,0.09302325581395349,0.046511627906976744,2.1972245773362196,4.454347296253507
7052,3,86,No,6,4,258,89,516,344,18,92,0.034482758620689655,0.06896551724137931,1.3862943611198906,4.465908118654584
8159,4,63,Yes,9,1,252,67,567,63,36,72,0.0625,0.140625,1.6094379124341003,4.1588830833596715
9897,6,74,No,6,6,444,80,444,444,36,80,0.08,0.08,1.9459101490553132,4.31748811353631
2250,1,41,Yes,8,2,41,42,328,82,8,49,0.023809523809523808,0.19047619047619047,0.6931471805599453,3.7376696182833684
4641,6,49,No,8,8,294,55,392,392,48,57,0.12,0.16,1.9459101490553132,3.912023005428146
9486,9,81,No,4,4,729,90,324,324,36,85,0.10975609756097561,0.04878048780487805,2.302585092994046,4.406719247264253
4948,6,94,Yes,9,2,564,100,846,188,54,103,0.06315789473684211,0.09473684210526316,1.9459101490553132,4.553876891600541
9921,3,52,No,7,1,156,55,364,52,21,59,0.05660377358490566,0.1320754716981132,1.3862943611198906,3.970291913552122
1964,5,44,No,7,1,220,49,308,44,35,51,0.1111111111111111,0.15555555555555556,1.791759469228055,3.8066624897703196
8244,7,96,Yes,6,9,672,103,576,864,42,102,0.07216494845360824,0.061855670103092786,2.0794415416798357,4.574710978503383
6591,9,54,Yes,6,5,486,63,324,270,54,60,0.16363636363636364,0.10909090909090909,2.302585092994046,4.007333185232471
8848,6,68,Yes,5,5,408,74,340,340,30,73,0.08695652173913043,0.07246376811594203,1.9459101490553132,4.23410650459726
322,7,70,Yes,4,2,490,77,280,140,28,74,0.09859154929577464,0.056338028169014086,2.0794415416798357,4.2626798770413155
2679,2,55,Yes,8,9,110,57,440,495,16,63,0.03571428571428571,0.14285714285714285,1.0986122886681098,4.02535169073515
4626,2,61,Yes,6,7,122,63,366,427,12,67,0.03225806451612903,0.0967741935483871,1.0986122886681098,4.127134385045092
4950,9,54,No,6,2,486,63,324,108,54,60,0.16363636363636364,0.10909090909090909,2.302585092994046,4.007333185232471
8329,2,59,Yes,4,2,118,61,236,118,8,63,0.03333333333333333,0.06666666666666667,1.0986122886681098,4.0943445622221
3338,9,66,No,8,5,594,75,528,330,72,74,0.13432835820895522,0.11940298507462686,2.302585092994046,4.204692619390966
5590,9,52,Yes,7,7,468,61,364,364,63,59,0.16981132075471697,0.1320754716981132,2.302585092994046,3.970291913552122
252,7,55,Yes,8,1,385,62,440,55,56,63,0.125,0.14285714285714285,2.0794415416798357,4.02535169073515
3974,7,83,No,9,8,581,90,747,664,63,92,0.08333333333333333,0.10714285714285714,2.0794415416798357,4.430816798843313
6631,6,89,Yes,7,6,534,95,623,534,42,96,0.06666666666666667,0.07777777777777778,1.9459101490553132,4.499809670330265
5548,9,83,Yes,7,3,747,92,581,249,63,90,0.10714285714285714,0.08333333333333333,2.302585092994046,4.430816798843313
36,2,97,Yes,9,4,194,99,873,388,18,106,0.02040816326530612,0.09183673469387756,1.0986122886681098,4.584967478670572
8363,7,77,Yes,4,7,539,84,308,539,28,81,0.08974358974358974,0.05128205128205128,2.0794415416798357,4.356708826689592
1514,8,99,No,8,1,792,107,792,99,64,107,0.08,0.08,2.1972245773362196,4.605170185988092
9318,5,83,Yes,8,6,415,88,664,498,40,91,0.05952380952380952,0.09523809523809523,1.791759469228055,4.430816798843313
40,9,68,No,5,3,612,77,340,204,45,73,0.13043478260869565,0.07246376811594203,2.302585092994046,4.23410650459726
4820,7,84,Yes,5,0,588,91,420,0,35,89,0.08235294117647059,0.058823529411764705,2.0794415416798357,4.442651256490317
3466,6,80,Yes,8,3,480,86,640,240,48,88,0.07407407407407407,0.09876543209876543,1.9459101490553132,4.394449154672439
1761,8,80,No,7,9,640,88,560,720,56,87,0.09876543209876543,0.08641975308641975,2.1972245773362196,4.394449154672439
2305,5,57,No,5,8,285,62,285,456,25,62,0.08620689655172414,0.08620689655172414,1.791759469228055,4.060443010546419
3724,1,96,No,8,5,96,97,768,480,8,104,0.010309278350515464,0.08247422680412371,0.6931471805599453,4.574710978503383
8285,3,77,No,8,4,231,80,616,308,24,85,0.038461538461538464,0.10256410256410256,1.3862943611198906,4.356708826689592
4994,3,91,Yes,7,9,273,94,637,819,21,98,0.03260869565217391,0.07608695652173914,1.3862943611198906,4.5217885770490405
8128,8,89,No,5,8,712,97,445,712,40,94,0.08888888888888889,0.05555555555555555,2.1972245773362196,4.499809670330265
3033,9,77,No,5,7,693,86,385,539,45,82,0.11538461538461539,0.0641025641025641,2.302585092994046,4.356708826689592
7939,8,95,Yes,6,6,760,103,570,570,48,101,0.08333333333333333,0.0625,2.1972245773362196,4.564348191467836
3040,9,77,No,7,3,693,86,539,231,63,84,0.11538461538461539,0.08974358974358974,2.302585092994046,4.356708826689592
9656,8,93,No,8,3,744,101,744,279,64,101,0.0851063829787234,0.0851063829787234,2.1972245773362196,4.543294782270004
2546,4,91,No,8,0,364,95,728,0,32,99,0.043478260869565216,0.08695652173913043,1.6094379124341003,4.5217885770490405
2593,6,71,No,8,6,426,77,568,426,48,79,0.08333333333333333,0.1111111111111111,1.9459101490553132,4.276666119016055
1189,7,47,No,5,5,329,54,235,235,35,52,0.14583333333333334,0.10416666666666667,2.0794415416798357,3.871201010907891
7967,4,52,No,9,5,208,56,468,260,36,61,0.07547169811320754,0.16981132075471697,1.6094379124341003,3.970291913552122
6078,2,41,No,4,3,82,43,164,123,8,45,0.047619047619047616,0.09523809523809523,1.0986122886681098,3.7376696182833684
108,9,83,Yes,8,7,747,92,664,581,72,91,0.10714285714285714,0.09523809523809523,2.302585092994046,4.430816798843313
1316,5,98,Yes,6,7,490,103,588,686,30,104,0.050505050505050504,0.06060606060606061,1.791759469228055,4.59511985013459
8188,9,40,No,5,7,360,49,200,280,45,45,0.21951219512195122,0.12195121951219512,2.302585092994046,3.713572066704308
2754,1,54,Yes,8,8,54,55,432,432,8,62,0.01818181818181818,0.14545454545454545,0.6931471805599453,4.007333185232471
9754,3,87,Yes,8,1,261,90,696,87,24,95,0.03409090909090909,0.09090909090909091,1.3862943611198906,4.477336814478207
6232,4,55,Yes,6,3,220,59,330,165,24,61,0.07142857142857142,0.10714285714285714,1.6094379124341003,4.02535169073515
2877,5,85,Yes,8,5,425,90,680,425,40,93,0.05813953488372093,0.09302325581395349,1.791759469228055,4.454347296253507
5324,7,72,No,4,0,504,79,288,0,28,76,0.0958904109589041,0.0547945205479452,2.0794415416798357,4.290459441148391
800,8,97,No,7,3,776,105,679,291,56,104,0.08163265306122448,0.07142857142857142,2.1972245773362196,4.584967478670572
3571,8,92,No,9,8,736,100,828,736,72,101,0.08602150537634409,0.0967741935483871,2.1972245773362196,4.532599493153256
2895,9,93,Yes,7,9,837,102,651,837,63,100,0.09574468085106383,0.07446808510638298,2.302585092994046,4.543294782270004
2928,2,93,No,8,3,186,95,744,279,16,101,0.02127659574468085,0.0851063829787234,1.0986122886681098,4.543294782270004
8179,5,53,Yes,9,2,265,58,477,106,45,62,0.09259259259259259,0.16666666666666666,1.791759469228055,3.9889840465642745
972,3,86,No,4,8,258,89,344,688,12,90,0.034482758620689655,0.04597701149425287,1.3862943611198906,4.465908118654584
6688,2,65,Yes,9,5,130,67,585,325,18,74,0.030303030303030304,0.13636363636363635,1.0986122886681098,4.189654742026425
8576,3,64,No,9,9,192,67,576,576,27,73,0.046153846153846156,0.13846153846153847,1.3862943611198906,4.174387269895637
2021,9,78,No,7,4,702,87,546,312,63,85,0.11392405063291139,0.08860759493670886,2.302585092994046,4.3694478524670215
9055,9,67,Yes,6,7,603,76,402,469,54,73,0.1323529411764706,0.08823529411764706,2.302585092994046,4.219507705176107
953,1,87,No,6,6,87,88,522,522,6,93,0.011363636363636364,0.06818181818181818,0.6931471805599453,4.477336814478207
5360,3,85,Yes,5,2,255,88,425,170,15,90,0.03488372093023256,0.05813953488372093,1.3862943611198906,4.454347296253507
3858,8,56,No,7,4,448,64,392,224,56,63,0.14035087719298245,0.12280701754385964,2.1972245773362196,4.04305126783455
5862,2,82,No,9,2,164,84,738,164,18,91,0.024096385542168676,0.10843373493975904,1.0986122886681098,4.418840607796598
3146,8,43,Yes,4,5,344,51,172,215,32,47,0.18181818181818182,0.09090909090909091,2.1972245773362196,3.784189633918261
3306,4,46,No,7,3,184,50,322,138,28,53,0.0851063829787234,0.14893617021276595,1.6094379124341003,3.8501476017100584
3007,9,83,No,8,9,747,92,664,747,72,91,0.10714285714285714,0.09523809523809523,2.302585092994046,4.430816798843313
9002,8,71,No,9,5,568,79,639,355,72,80,0.1111111111111111,0.125,2.1972245773362196,4.276666119016055
7771,1,54,No,6,1,54,55,324,54,6,60,0.01818181818181818,0.10909090909090909,0.6931471805599453,4.007333185232471
7439,1,48,Yes,4,2,48,49,192,96,4,52,0.02040816326530612,0.08163265306122448,0.6931471805599453,3.8918202981106265
7943,3,43,Yes,8,4,129,46,344,172,24,51,0.06818181818181818,0.18181818181818182,1.3862943611198906,3.784189633918261
9239,5,46,No,5,9,230,51,230,414,25,51,0.10638297872340426,0.10638297872340426,1.791759469228055,3.8501476017100584
1057,9,79,No,6,2,711,88,474,158,54,85,0.1125,0.075,2.302585092994046,4.382026634673881
3155,9,98,Yes,6,9,882,107,588,882,54,104,0.09090909090909091,0.06060606060606061,2.302585092994046,4.59511985013459
3788,4,98,No,5,1,392,102,490,98,20,103,0.04040404040404041,0.050505050505050504,1.6094379124341003,4.59511985013459
9190,3,84,Yes,5,3,252,87,420,252,15,89,0.03529411764705882,0.058823529411764705,1.3862943611198906,4.442651256490317
7826,8,95,No,5,0,760,103,475,0,40,100,0.08333333333333333,0.052083333333333336,2.1972245773362196,4.564348191467836
7540,7,96,No,5,3,672,103,480,288,35,101,0.07216494845360824,0.05154639175257732,2.0794415416798357,4.574710978503383
7232,9,62,Yes,9,6,558,71,558,372,81,71,0.14285714285714285,0.14285714285714285,2.302585092994046,4.143134726391533
765,6,92,Yes,9,4,552,98,828,368,54,101,0.06451612903225806,0.0967741935483871,1.9459101490553132,4.532599493153256
5020,1,54,No,7,7,54,55,378,378,7,61,0.01818181818181818,0.12727272727272726,0.6931471805599453,4.007333185232471
4904,7,45,Yes,6,6,315,52,270,270,42,51,0.15217391304347827,0.13043478260869565,2.0794415416798357,3.828641396489095
8094,5,70,Yes,4,6,350,75,280,420,20,74,0.07042253521126761,0.056338028169014086,1.791759469228055,4.2626798770413155
6844,1,47,Yes,5,0,47,48,235,0,5,52,0.020833333333333332,0.10416666666666667,0.6931471805599453,3.871201010907891
2166,9,75,No,8,4,675,84,600,300,72,83,0.11842105263157894,0.10526315789473684,2.302585092994046,4.330733340286331
1863,6,61,Yes,6,1,366,67,366,61,36,67,0.0967741935483871,0.0967741935483871,1.9459101490553132,4.127134385045092
7851,8,84,No,9,5,672,92,756,420,72,93,0.09411764705882353,0.10588235294117647,2.1972245773362196,4.442651256490317
9124,6,87,No,5,2,522,93,435,174,30,92,0.06818181818181818,0.056818181818181816,1.9459101490553132,4.477336814478207
2341,2,61,Yes,9,2,122,63,549,122,18,70,0.03225806451612903,0.14516129032258066,1.0986122886681098,4.127134385045092
5528,2,72,No,6,5,144,74,432,360,12,78,0.0273972602739726,0.0821917808219178,1.0986122886681098,4.290459441148391
6744,3,43,Yes,6,5,129,46,258,215,18,49,0.06818181818181818,0.13636363636363635,1.3862943611198906,3.784189633918261
4004,3,57,Yes,7,2,171,60,399,114,21,64,0.05172413793103448,0.1206896551724138,1.3862943611198906,4.060443010546419
1124,2,51,Yes,4,2,102,53,204,102,8,55,0.038461538461538464,0.07692307692307693,1.0986122886681098,3.9512437185814275
8710,3,46,No,8,7,138,49,368,322,24,54,0.06382978723404255,0.1702127659574468,1.3862943611198906,3.8501476017100584
4050,1,54,No,5,0,54,55,270,0,5,59,0.01818181818181818,0.09090909090909091,0.6931471805599453,4.007333185232471
7641,2,74,Yes,6,8,148,76,444,592,12,80,0.02666666666666667,0.08,1.0986122886681098,4.31748811353631
766,3,45,Yes,7,4,135,48,315,180,21,52,0.06521739130434782,0.15217391304347827,1.3862943611198906,3.828641396489095
2345,2,48,Yes,5,0,96,50,240,0,10,53,0.04081632653061224,0.10204081632653061,1.0986122886681098,3.8918202981106265
4072,1,79,No,4,5,79,80,316,395,4,83,0.0125,0.05,0.6931471805599453,4.382026634673881
7217,4,56,No,6,2,224,60,336,112,24,62,0.07017543859649122,0.10526315789473684,1.6094379124341003,4.04305126783455
4217,8,83,No,6,0,664,91,498,0,48,89,0.09523809523809523,0.07142857142857142,2.1972245773362196,4.430816798843313
7953,8,92,Yes,7,7,736,100,644,644,56,99,0.08602150537634409,0.07526881720430108,2.1972245773362196,4.532599493153256
5971,6,60,Yes,9,1,360,66,540,60,54,69,0.09836065573770492,0.14754098360655737,1.9459101490553132,4.110873864173311
3351,5,64,No,5,8,320,69,320,512,25,69,0.07692307692307693,0.07692307692307693,1.791759469228055,4.174387269895637
4696,6,72,Yes,6,4,432,78,432,288,36,78,0.0821917808219178,0.0821917808219178,1.9459101490553132,4.290459441148391
3400,3,73,Yes,6,8,219,76,438,584,18,79,0.04054054054054054,0.08108108108108109,1.3862943611198906,4.30406509320417
4082,6,80,Yes,9,1,480,86,720,80,54,89,0.07407407407407407,0.1111111111111111,1.9459101490553132,4.394449154672439
9150,4,91,No,8,0,364,95,728,0,32,99,0.043478260869565216,0.08695652173913043,1.6094379124341003,4.5217885770490405
1225,9,60,Yes,7,1,540,69,420,60,63,67,0.14754098360655737,0.11475409836065574,2.302585092994046,4.110873864173311
6293,3,82,Yes,9,5,246,85,738,410,27,91,0.03614457831325301,0.10843373493975904,1.3862943611198906,4.418840607796598
3123,8,59,Yes,4,7,472,67,236,413,32,63,0.13333333333333333,0.06666666666666667,2.1972245773362196,4.0943445622221
511,7,75,No,8,6,525,82,600,450,56,83,0.09210526315789473,0.10526315789473684,2.0794415416798357,4.330733340286331
5795,5,81,No,5,7,405,86,405,567,25,86,0.06097560975609756,0.06097560975609756,1.791759469228055,4.406719247264253
8182,1,47,No,8,7,47,48,376,329,8,55,0.020833333333333332,0.16666666666666666,0.6931471805599453,3.871201010907891
9418,7,98,Yes,7,5,686,105,686,490,49,105,0.0707070707070707,0.0707070707070707,2.0794415416798357,4.59511985013459
97,8,64,No,5,1,512,72,320,64,40,69,0.12307692307692308,0.07692307692307693,2.1972245773362196,4.174387269895637
6682,9,42,No,4,4,378,51,168,168,36,46,0.20930232558139536,0.09302325581395349,2.302585092994046,3.7612001156935624
1513,5,55,Yes,4,5,275,60,220,275,20,59,0.08928571428571429,0.07142857142857142,1.791759469228055,4.02535169073515
8792,1,41,No,8,8,41,42,328,328,8,49,0.023809523809523808,0.19047619047619047,0.6931471805599453,3.7376696182833684
120,6,55,Yes,4,9,330,61,220,495,24,59,0.10714285714285714,0.07142857142857142,1.9459101490553132,4.02535169073515
7792,1,41,No,4,3,41,42,164,123,4,45,0.023809523809523808,0.09523809523809523,0.6931471805599453,3.7376696182833684
6518,7,51,No,4,0,357,58,204,0,28,55,0.1346153846153846,0.07692307692307693,2.0794415416798357,3.9512437185814275
34,9,52,Yes,8,1,468,61,416,52,72,60,0.16981132075471697,0.1509433962264151,2.302585092994046,3.970291913552122
7888,9,62,Yes,7,2,558,71,434,124,63,69,0.14285714285714285,0.1111111111111111,2.302585092994046,4.143134726391533
6831,1,69,No,6,6,69,70,414,414,6,75,0.014285714285714285,0.08571428571428572,0.6931471805599453,4.248495242049359
5422,3,58,Yes,8,7,174,61,464,406,24,66,0.05084745762711865,0.13559322033898305,1.3862943611198906,4.07753744390572
1069,6,78,Yes,5,1,468,84,390,78,30,83,0.0759493670886076,0.06329113924050633,1.9459101490553132,4.3694478524670215
1348,2,41,No,9,1,82,43,369,41,18,50,0.047619047619047616,0.21428571428571427,1.0986122886681098,3.7376696182833684
4748,3,49,No,8,7,147,52,392,343,24,57,0.06,0.16,1.3862943611198906,3.912023005428146
6006,7,53,No,5,3,371,60,265,159,35,58,0.12962962962962962,0.09259259259259259,2.0794415416798357,3.9889840465642745
6040,9,49,No,5,0,441,58,245,0,45,54,0.18,0.1,2.302585092994046,3.912023005428146
3818,8,82,Yes,6,2,656,90,492,164,48,88,0.0963855421686747,0.07228915662650602,2.1972245773362196,4.418840607796598
8447,8,52,No,5,2,416,60,260,104,40,57,0.1509433962264151,0.09433962264150944,2.1972245773362196,3.970291913552122
5270,1,92,No,9,5,92,93,828,460,9,101,0.010752688172043012,0.0967741935483871,0.6931471805599453,4.532599493153256
6898,2,42,No,8,8,84,44,336,336,16,50,0.046511627906976744,0.18604651162790697,1.0986122886681098,3.7612001156935624
5310,3,54,Yes,4,3,162,57,216,162,12,58,0.05454545454545454,0.07272727272727272,1.3862943611198906,4.007333185232471
32,7,44,Yes,9,1,308,51,396,44,63,53,0.15555555555555556,0.2,2.0794415416798357,3.8066624897703196
5675,2,72,No,7,5,144,74,504,360,14,79,0.0273972602739726,0.0958904109589041,1.0986122886681098,4.290459441148391
4387,3,40,No,4,6,120,43,160,240,12,44,0.07317073170731707,0.0975609756097561,1.3862943611198906,3.713572066704308
30,5,90,Yes,4,3,450,95,360,270,20,94,0.054945054945054944,0.04395604395604396,1.791759469228055,4.51085950651685
4203,3,54,Yes,4,5,162,57,216,270,12,58,0.05454545454545454,0.07272727272727272,1.3862943611198906,4.007333185232471
7508,2,92,Yes,4,3,184,94,368,276,8,96,0.021505376344086023,0.043010752688172046,1.0986122886681098,4.532599493153256
736,6,41,No,5,9,246,47,205,369,30,46,0.14285714285714285,0.11904761904761904,1.9459101490553132,3.7376696182833684
2068,8,47,No,8,8,376,55,376,376,64,55,0.16666666666666666,0.16666666666666666,2.1972245773362196,3.871201010907891
107,7,90,Yes,4,1,630,97,360,90,28,94,0.07692307692307693,0.04395604395604396,2.0794415416798357,4.51085950651685
9645,4,91,Yes,4,3,364,95,364,273,16,95,0.043478260869565216,0.043478260869565216,1.6094379124341003,4.5217885770490405
8895,1,43,No,9,0,43,44,387,0,9,52,0.022727272727272728,0.20454545454545456,0.6931471805599453,3.784189633918261
8021,2,77,Yes,5,0,154,79,385,0,10,82,0.02564102564102564,0.0641025641025641,1.0986122886681098,4.356708826689592
2233,5,69,No,9,7,345,74,621,483,45,78,0.07142857142857142,0.12857142857142856,1.791759469228055,4.248495242049359
994,2,70,Yes,7,9,140,72,490,630,14,77,0.028169014084507043,0.09859154929577464,1.0986122886681098,4.2626798770413155
9413,8,75,No,4,1,600,83,300,75,32,79,0.10526315789473684,0.05263157894736842,2.1972245773362196,4.330733340286331
7059,5,66,No,5,3,330,71,330,198,25,71,0.07462686567164178,0.07462686567164178,1.791759469228055,4.204692619390966
6790,6,71,Yes,5,5,426,77,355,355,30,76,0.08333333333333333,0.06944444444444445,1.9459101490553132,4.276666119016055
361,8,88,No,5,8,704,96,440,704,40,93,0.0898876404494382,0.056179775280898875,2.1972245773362196,4.48863636973214
305,6,49,No,6,0,294,55,294,0,36,55,0.12,0.12,1.9459101490553132,3.912023005428146
2628,7,52,No,5,8,364,59,260,416,35,57,0.1320754716981132,0.09433962264150944,2.0794415416798357,3.970291913552122
8966,5,91,Yes,8,1,455,96,728,91,40,99,0.05434782608695652,0.08695652173913043,1.791759469228055,4.5217885770490405
4514,4,73,Yes,7,6,292,77,511,438,28,80,0.05405405405405406,0.0945945945945946,1.6094379124341003,4.30406509320417
5911,2,77,No,9,1,154,79,693,77,18,86,0.02564102564102564,0.11538461538461539,1.0986122886681098,4.356708826689592
8314,4,59,Yes,4,7,236,63,236,413,16,63,0.06666666666666667,0.06666666666666667,1.6094379124341003,4.0943445622221
3101,7,52,No,5,2,364,59,260,104,35,57,0.1320754716981132,0.09433962264150944,2.0794415416798357,3.970291913552122
5704,6,68,No,9,7,408,74,612,476,54,77,0.08695652173913043,0.13043478260869565,1.9459101490553132,4.23410650459726
3899,3,54,Yes,7,7,162,57,378,378,21,61,0.05454545454545454,0.12727272727272726,1.3862943611198906,4.007333185232471
5441,2,79,No,9,0,158,81,711,0,18,88,0.025,0.1125,1.0986122886681098,4.382026634673881
7931,2,70,Yes,7,8,140,72,490,560,14,77,0.028169014084507043,0.09859154929577464,1.0986122886681098,4.2626798770413155
622,5,91,Yes,4,8,455,96,364,728,20,95,0.05434782608695652,0.043478260869565216,1.791759469228055,4.5217885770490405
7236,4,65,No,4,7,260,69,260,455,16,69,0.06060606060606061,0.06060606060606061,1.6094379124341003,4.189654742026425
2499,1,63,Yes,8,3,63,64,504,189,8,71,0.015625,0.125,0.6931471805599453,4.1588830833596715
714,6,76,No,8,2,456,82,608,152,48,84,0.07792207792207792,0.1038961038961039,1.9459101490553132,4.343805421853684
8404,4,83,Yes,4,6,332,87,332,498,16,87,0.047619047619047616,0.047619047619047616,1.6094379124341003,4.430816798843313
2856,4,98,No,7,5,392,102,686,490,28,105,0.04040404040404041,0.0707070707070707,1.6094379124341003,4.59511985013459
4270,6,83,No,7,4,498,89,581,332,42,90,0.07142857142857142,0.08333333333333333,1.9459101490553132,4.430816798843313
2909,9,93,Yes,7,9,837,102,651,837,63,100,0.09574468085106383,0.07446808510638298,2.302585092994046,4.543294782270004
8081,1,69,Yes,4,0,69,70,276,0,4,73,0.014285714285714285,0.05714285714285714,0.6931471805599453,4.248495242049359
4517,2,94,Yes,9,1,188,96,846,94,18,103,0.021052631578947368,0.09473684210526316,1.0986122886681098,4.553876891600541
1262,3,52,Yes,9,1,156,55,468,52,27,61,0.05660377358490566,0.16981132075471697,1.3862943611198906,3.970291913552122
3161,4,41,No,5,0,164,45,205,0,20,46,0.09523809523809523,0.11904761904761904,1.6094379124341003,3.7376696182833684
971,8,52,No,7,1,416,60,364,52,56,59,0.1509433962264151,0.1320754716981132,2.1972245773362196,3.970291913552122
3913,4,98,Yes,4,9,392,102,392,882,16,102,0.04040404040404041,0.04040404040404041,1.6094379124341003,4.59511985013459
5199,6,48,Yes,5,4,288,54,240,192,30,53,0.12244897959183673,0.10204081632653061,1.9459101490553132,3.8918202981106265
8847,9,65,Yes,9,9,585,74,585,585,81,74,0.13636363636363635,0.13636363636363635,2.302585092994046,4.189654742026425
260,6,86,Yes,4,8,516,92,344,688,24,90,0.06896551724137931,0.04597701149425287,1.9459101490553132,4.465908118654584
3791,9,46,No,8,4,414,55,368,184,72,54,0.19148936170212766,0.1702127659574468,2.302585092994046,3.8501476017100584
9203,9,95,Yes,5,5,855,104,475,475,45,100,0.09375,0.052083333333333336,2.302585092994046,4.564348191467836
488,5,52,Yes,9,8,260,57,468,416,45,61,0.09433962264150944,0.16981132075471697,1.791759469228055,3.970291913552122
7908,4,47,Yes,9,9,188,51,423,423,36,56,0.08333333333333333,0.1875,1.6094379124341003,3.871201010907891
519,6,85,Yes,6,5,510,91,510,425,36,91,0.06976744186046512,0.06976744186046512,1.9459101490553132,4.454347296253507
8343,8,41,No,8,5,328,49,328,205,64,49,0.19047619047619047,0.19047619047619047,2.1972245773362196,3.7376696182833684
312,7,99,No,4,8,693,106,396,792,28,103,0.07,0.04,2.0794415416798357,4.605170185988092
3232,6,70,No,7,3,420,76,490,210,42,77,0.08450704225352113,0.09859154929577464,1.9459101490553132,4.2626798770413155
7933,3,49,No,6,0,147,52,294,0,18,55,0.06,0.12,1.3862943611198906,3.912023005428146
7458,4,40,No,9,1,160,44,360,40,36,49,0.0975609756097561,0.21951219512195122,1.6094379124341003,3.713572066704308
9784,2,55,Yes,7,0,110,57,385,0,14,62,0.03571428571428571,0.125,1.0986122886681098,4.02535169073515
5184,3,41,No,8,8,123,44,328,328,24,49,0.07142857142857142,0.19047619047619047,1.3862943611198906,3.7376696182833684
8077,3,92,No,4,4,276,95,368,368,12,96,0.03225806451612903,0.043010752688172046,1.3862943611198906,4.532599493153256
6502,1,40,No,7,4,40,41,280,160,7,47,0.024390243902439025,0.17073170731707318,0.6931471805599453,3.713572066704308
6791,1,45,Yes,6,9,45,46,270,405,6,51,0.021739130434782608,0.13043478260869565,0.6931471805599453,3.828641396489095
7773,2,45,No,4,0,90,47,180,0,8,49,0.043478260869565216,0.08695652173913043,1.0986122886681098,3.828641396489095
2738,8,53,Yes,4,3,424,61,212,159,32,57,0.14814814814814814,0.07407407407407407,2.1972245773362196,3.9889840465642745
7842,7,54,Yes,8,9,378,61,432,486,56,62,0.12727272727272726,0.14545454545454545,2.0794415416798357,4.007333185232471
6262,5,62,No,6,1,310,67,372,62,30,68,0.07936507936507936,0.09523809523809523,1.791759469228055,4.143134726391533
8206,9,81,No,7,6,729,90,567,486,63,88,0.10975609756097561,0.08536585365853659,2.302585092994046,4.406719247264253
1248,3,45,No,9,5,135,48,405,225,27,54,0.06521739130434782,0.1956521739130435,1.3862943611198906,3.828641396489095
9336,3,42,No,9,5,126,45,378,210,27,51,0.06976744186046512,0.20930232558139536,1.3862943611198906,3.7612001156935624
4195,6,59,Yes,6,6,354,65,354,354,36,65,0.1,0.1,1.9459101490553132,4.0943445622221
8001,2,50,No,4,1,100,52,200,50,8,54,0.0392156862745098,0.0784313725490196,1.0986122886681098,3.9318256327243257
7378,9,45,Yes,4,9,405,54,180,405,36,49,0.1956521739130435,0.08695652173913043,2.302585092994046,3.828641396489095
3435,3,79,Yes,6,0,237,82,474,0,18,85,0.0375,0.075,1.3862943611198906,4.382026634673881
5382,8,76,No,9,4,608,84,684,304,72,85,0.1038961038961039,0.11688311688311688,2.1972245773362196,4.343805421853684
959,4,99,Yes,4,4,396,103,396,396,16,103,0.04,0.04,1.6094379124341003,4.605170185988092
417,3,83,Yes,4,2,249,86,332,166,12,87,0.03571428571428571,0.047619047619047616,1.3862943611198906,4.430816798843313
5742,2,59,Yes,6,2,118,61,354,118,12,65,0.03333333333333333,0.1,1.0986122886681098,4.0943445622221
6728,7,90,Yes,6,8,630,97,540,720,42,96,0.07692307692307693,0.06593406593406594,2.0794415416798357,4.51085950651685
4382,5,95,No,8,1,475,100,760,95,40,103,0.052083333333333336,0.08333333333333333,1.791759469228055,4.564348191467836
5197,4,83,No,8,4,332,87,664,332,32,91,0.047619047619047616,0.09523809523809523,1.6094379124341003,4.430816798843313
1113,5,81,Yes,4,0,405,86,324,0,20,85,0.06097560975609756,0.04878048780487805,1.791759469228055,4.406719247264253
2689,3,40,No,4,7,120,43,160,280,12,44,0.07317073170731707,0.0975609756097561,1.3862943611198906,3.713572066704308
6473,6,74,No,6,9,444,80,444,666,36,80,0.08,0.08,1.9459101490553132,4.31748811353631
8820,1,61,Yes,8,6,61,62,488,366,8,69,0.016129032258064516,0.12903225806451613,0.6931471805599453,4.127134385045092
7808,4,53,Yes,9,8,212,57,477,424,36,62,0.07407407407407407,0.16666666666666666,1.6094379124341003,3.9889840465642745
3411,7,73,No,4,0,511,80,292,0,28,77,0.0945945945945946,0.05405405405405406,2.0794415416798357,4.30406509320417
81,3,69,No,4,7,207,72,276,483,12,73,0.04285714285714286,0.05714285714285714,1.3862943611198906,4.248495242049359
4614,9,74,Yes,9,6,666,83,666,444,81,83,0.12,0.12,2.302585092994046,4.31748811353631
1374,7,78,Yes,8,5,546,85,624,390,56,86,0.08860759493670886,0.10126582278481013,2.0794415416798357,4.3694478524670215
1510,1,96,No,7,5,96,97,672,480,7,103,0.010309278350515464,0.07216494845360824,0.6931471805599453,4.574710978503383
6443,6,70,No,4,7,420,76,280,490,24,74,0.08450704225352113,0.056338028169014086,1.9459101490553132,4.2626798770413155
3071,5,58,Yes,8,8,290,63,464,464,40,66,0.0847457627118644,0.13559322033898305,1.791759469228055,4.07753744390572
3016,1,66,No,6,8,66,67,396,528,6,72,0.014925373134328358,0.08955223880597014,0.6931471805599453,4.204692619390966
4823,3,97,No,6,4,291,100,582,388,18,103,0.030612244897959183,0.061224489795918366,1.3862943611198906,4.584967478670572
7822,1,66,Yes,6,3,66,67,396,198,6,72,0.014925373134328358,0.08955223880597014,0.6931471805599453,4.204692619390966
93,7,67,Yes,8,7,469,74,536,469,56,75,0.10294117647058823,0.11764705882352941,2.0794415416798357,4.219507705176107
9421,9,73,Yes,5,0,657,82,365,0,45,78,0.12162162162162163,0.06756756756756757,2.302585092994046,4.30406509320417
6600,3,97,No,4,9,291,100,388,873,12,101,0.030612244897959183,0.04081632653061224,1.3862943611198906,4.584967478670572
4443,2,97,No,9,5,194,99,873,485,18,106,0.02040816326530612,0.09183673469387756,1.0986122886681098,4.584967478670572
7602,8,87,No,5,2,696,95,435,174,40,92,0.09090909090909091,0.056818181818181816,2.1972245773362196,4.477336814478207
3835,5,81,No,4,6,405,86,324,486,20,85,0.06097560975609756,0.04878048780487805,1.791759469228055,4.406719247264253
9702,5,79,No,4,9,395,84,316,711,20,83,0.0625,0.05,1.791759469228055,4.382026634673881
4322,5,70,No,8,2,350,75,560,140,40,78,0.07042253521126761,0.11267605633802817,1.791759469228055,4.2626798770413155
3394,3,81,No,7,0,243,84,567,0,21,88,0.036585365853658534,0.08536585365853659,1.3862943611198906,4.406719247264253
4752,6,48,No,6,7,288,54,288,336,36,54,0.12244897959183673,0.12244897959183673,1.9459101490553132,3.8918202981106265
7229,1,81,No,5,7,81,82,405,567,5,86,0.012195121951219513,0.06097560975609756,0.6931471805599453,4.406719247264253
9191,7,57,Yes,5,1,399,64,285,57,35,62,0.1206896551724138,0.08620689655172414,2.0794415416798357,4.060443010546419
2361,8,41,Yes,4,4,328,49,164,164,32,45,0.19047619047619047,0.09523809523809523,2.1972245773362196,3.7376696182833684
1148,1,42,No,4,3,42,43,168,126,4,46,0.023255813953488372,0.09302325581395349,0.6931471805599453,3.7612001156935624
5666,5,84,No,9,6,420,89,756,504,45,93,0.058823529411764705,0.10588235294117647,1.791759469228055,4.442651256490317
8075,4,59,No,9,2,236,63,531,118,36,68,0.06666666666666667,0.15,1.6094379124341003,4.0943445622221
4943,1,48,Yes,7,9,48,49,336,432,7,55,0.02040816326530612,0.14285714285714285,0.6931471805599453,3.8918202981106265
3663,7,57,No,6,9,399,64,342,513,42,63,0.1206896551724138,0.10344827586206896,2.0794415416798357,4.060443010546419
1563,3,96,Yes,6,8,288,99,576,768,18,102,0.030927835051546393,0.061855670103092786,1.3862943611198906,4.574710978503383
4113,1,49,No,4,0,49,50,196,0,4,53,0.02,0.08,0.6931471805599453,3.912023005428146
9050,5,77,Yes,6,2,385,82,462,154,30,83,0.0641025641025641,0.07692307692307693,1.791759469228055,4.356708826689592
9276,2,98,No,7,4,196,100,686,392,14,105,0.020202020202020204,0.0707070707070707,1.0986122886681098,4.59511985013459
8538,7,49,No,7,9,343,56,343,441,49,56,0.14,0.14,2.0794415416798357,3.912023005428146
795,1,94,No,9,4,94,95,846,376,9,103,0.010526315789473684,0.09473684210526316,0.6931471805599453,4.553876891600541
5854,9,62,Yes,5,6,558,71,310,372,45,67,0.14285714285714285,0.07936507936507936,2.302585092994046,4.143134726391533
7619,9,59,Yes,7,9,531,68,413,531,63,66,0.15,0.11666666666666667,2.302585092994046,4.0943445622221
1594,9,46,Yes,4,2,414,55,184,92,36,50,0.19148936170212766,0.0851063829787234,2.302585092994046,3.8501476017100584
7418,7,92,No,6,8,644,99,552,736,42,98,0.07526881720430108,0.06451612903225806,2.0794415416798357,4.532599493153256
5267,8,49,Yes,4,8,392,57,196,392,32,53,0.16,0.08,2.1972245773362196,3.912023005428146
7147,7,41,Yes,7,8,287,48,287,328,49,48,0.16666666666666666,0.16666666666666666,2.0794415416798357,3.7376696182833684
89,8,61,Yes,6,9,488,69,366,549,48,67,0.12903225806451613,0.0967741935483871,2.1972245773362196,4.127134385045092
8695,8,58,Yes,9,1,464,66,522,58,72,67,0.13559322033898305,0.15254237288135594,2.1972245773362196,4.07753744390572
9732,1,53,No,8,3,53,54,424,159,8,61,0.018518518518518517,0.14814814814814814,0.6931471805599453,3.9889840465642745
9446,7,47,Yes,8,6,329,54,376,282,56,55,0.14583333333333334,0.16666666666666666,2.0794415416798357,3.871201010907891
6754,5,84,Yes,7,0,420,89,588,0,35,91,0.058823529411764705,0.08235294117647059,1.791759469228055,4.442651256490317
3502,2,73,No,4,2,146,75,292,146,8,77,0.02702702702702703,0.05405405405405406,1.0986122886681098,4.30406509320417
2234,9,62,Yes,8,4,558,71,496,248,72,70,0.14285714285714285,0.12698412698412698,2.302585092994046,4.143134726391533
2803,2,80,No,4,0,160,82,320,0,8,84,0.024691358024691357,0.04938271604938271,1.0986122886681098,4.394449154672439
4424,4,66,No,6,7,264,70,396,462,24,72,0.05970149253731343,0.08955223880597014,1.6094379124341003,4.204692619390966
5663,7,75,Yes,6,1,525,82,450,75,42,81,0.09210526315789473,0.07894736842105263,2.0794415416798357,4.330733340286331
7170,7,79,No,5,9,553,86,395,711,35,84,0.0875,0.0625,2.0794415416798357,4.382026634673881
8337,4,87,No,5,0,348,91,435,0,20,92,0.045454545454545456,0.056818181818181816,1.6094379124341003,4.477336814478207
2148,4,52,Yes,6,5,208,56,312,260,24,58,0.07547169811320754,0.11320754716981132,1.6094379124341003,3.970291913552122
7969,1,63,No,7,8,63,64,441,504,7,70,0.015625,0.109375,0.6931471805599453,4.1588830833596715
6551,3,57,Yes,5,6,171,60,285,342,15,62,0.05172413793103448,0.08620689655172414,1.3862943611198906,4.060443010546419
7643,4,91,No,4,9,364,95,364,819,16,95,0.043478260869565216,0.043478260869565216,1.6094379124341003,4.5217885770490405
6164,9,79,Yes,6,9,711,88,474,711,54,85,0.1125,0.075,2.302585092994046,4.382026634673881
1495,5,83,No,8,2,415,88,664,166,40,91,0.05952380952380952,0.09523809523809523,1.791759469228055,4.430816798843313
7696,6,78,Yes,8,8,468,84,624,624,48,86,0.0759493670886076,0.10126582278481013,1.9459101490553132,4.3694478524670215
7094,8,42,Yes,8,0,336,50,336,0,64,50,0.18604651162790697,0.18604651162790697,2.1972245773362196,3.7612001156935624
1409,3,95,No,6,1,285,98,570,95,18,101,0.03125,0.0625,1.3862943611198906,4.564348191467836
6691,3,41,No,5,1,123,44,205,41,15,46,0.07142857142857142,0.11904761904761904,1.3862943611198906,3.7376696182833684
3401,4,67,Yes,7,7,268,71,469,469,28,74,0.058823529411764705,0.10294117647058823,1.6094379124341003,4.219507705176107
109,3,71,Yes,5,0,213,74,355,0,15,76,0.041666666666666664,0.06944444444444445,1.3862943611198906,4.276666119016055
5636,5,62,No,7,4,310,67,434,248,35,69,0.07936507936507936,0.1111111111111111,1.791759469228055,4.143134726391533
8482,3,47,No,4,2,141,50,188,94,12,51,0.0625,0.08333333333333333,1.3862943611198906,3.871201010907891
6604,2,56,No,4,0,112,58,224,0,8,60,0.03508771929824561,0.07017543859649122,1.0986122886681098,4.04305126783455
1091,1,89,Yes,4,1,89,90,356,89,4,93,0.011111111111111112,0.044444444444444446,0.6931471805599453,4.499809670330265
5560,3,97,Yes,5,9,291,100,485,873,15,102,0.030612244897959183,0.05102040816326531,1.3862943611198906,4.584967478670572
9412,7,64,Yes,4,7,448,71,256,448,28,68,0.1076923076923077,0.06153846153846154,2.0794415416798357,4.174387269895637
8143,8,42,No,8,4,336,50,336,168,64,50,0.18604651162790697,0.18604651162790697,2.1972245773362196,3.7612001156935624
8664,3,41,No,4,6,123,44,164,246,12,45,0.07142857142857142,0.09523809523809523,1.3862943611198906,3.7376696182833684
6596,9,45,Yes,4,8,405,54,180,360,36,49,0.1956521739130435,0.08695652173913043,2.302585092994046,3.828641396489095
624,3,68,No,7,3,204,71,476,204,21,75,0.043478260869565216,0.10144927536231885,1.3862943611198906,4.23410650459726
6871,4,53,No,6,8,212,57,318,424,24,59,0.07407407407407407,0.1111111111111111,1.6094379124341003,3.9889840465642745
4814,4,74,Yes,4,9,296,78,296,666,16,78,0.05333333333333334,0.05333333333333334,1.6094379124341003,4.31748811353631
6553,7,90,No,8,9,630,97,720,810,56,98,0.07692307692307693,0.08791208791208792,2.0794415416798357,4.51085950651685
7530,4,61,Yes,6,7,244,65,366,427,24,67,0.06451612903225806,0.0967741935483871,1.6094379124341003,4.127134385045092
5796,4,73,No,5,6,292,77,365,438,20,78,0.05405405405405406,0.06756756756756757,1.6094379124341003,4.30406509320417
7437,6,97,Yes,8,5,582,103,776,485,48,105,0.061224489795918366,0.08163265306122448,1.9459101490553132,4.584967478670572
4218,1,42,No,5,5,42,43,210,210,5,47,0.023255813953488372,0.11627906976744186,0.6931471805599453,3.7612001156935624
5941,5,74,Yes,4,2,370,79,296,148,20,78,0.06666666666666667,0.05333333333333334,1.791759469228055,4.31748811353631
8501,1,54,Yes,5,8,54,55,270,432,5,59,0.01818181818181818,0.09090909090909091,0.6931471805599453,4.007333185232471
6429,1,76,No,5,3,76,77,380,228,5,81,0.012987012987012988,0.06493506493506493,0.6931471805599453,4.343805421853684
6827,5,42,Yes,4,7,210,47,168,294,20,46,0.11627906976744186,0.09302325581395349,1.791759469228055,3.7612001156935624
4131,6,71,Yes,7,3,426,77,497,213,42,78,0.08333333333333333,0.09722222222222222,1.9459101490553132,4.276666119016055
7802,4,65,Yes,5,4,260,69,325,260,20,70,0.06060606060606061,0.07575757575757576,1.6094379124341003,4.189654742026425
7754,5,86,Yes,7,6,430,91,602,516,35,93,0.05747126436781609,0.08045977011494253,1.791759469228055,4.465908118654584
4722,9,54,Yes,4,7,486,63,216,378,36,58,0.16363636363636364,0.07272727272727272,2.302585092994046,4.007333185232471
1651,5,64,No,7,6,320,69,448,384,35,71,0.07692307692307693,0.1076923076923077,1.791759469228055,4.174387269895637
4141,8,90,Yes,4,3,720,98,360,270,32,94,0.08791208791208792,0.04395604395604396,2.1972245773362196,4.51085950651685
1618,7,92,No,9,1,644,99,828,92,63,101,0.07526881720430108,0.0967741935483871,2.0794415416798357,4.532599493153256
2030,8,98,Yes,5,9,784,106,490,882,40,103,0.08080808080808081,0.050505050505050504,2.1972245773362196,4.59511985013459
8518,4,53,No,9,5,212,57,477,265,36,62,0.07407407407407407,0.16666666666666666,1.6094379124341003,3.9889840465642745
4576,1,78,Yes,9,8,78,79,702,624,9,87,0.012658227848101266,0.11392405063291139,0.6931471805599453,4.3694478524670215
3993,2,78,Yes,8,2,156,80,624,156,16,86,0.02531645569620253,0.10126582278481013,1.0986122886681098,4.3694478524670215
7377,1,82,Yes,6,0,82,83,492,0,6,88,0.012048192771084338,0.07228915662650602,0.6931471805599453,4.418840607796598
6150,5,76,Yes,8,5,380,81,608,380,40,84,0.06493506493506493,0.1038961038961039,1.791759469228055,4.343805421853684
4909,6,90,Yes,7,8,540,96,630,720,42,97,0.06593406593406594,0.07692307692307693,1.9459101490553132,4.51085950651685
5027,7,81,Yes,9,4,567,88,729,324,63,90,0.08536585365853659,0.10975609756097561,2.0794415416798357,4.406719247264253
8261,4,61,Yes,7,1,244,65,427,61,28,68,0.06451612903225806,0.11290322580645161,1.6094379124341003,4.127134385045092
4732,7,73,No,8,3,511,80,584,219,56,81,0.0945945945945946,0.10810810810810811,2.0794415416798357,4.30406509320417
7549,3,80,Yes,7,2,240,83,560,160,21,87,0.037037037037037035,0.08641975308641975,1.3862943611198906,4.394449154672439
8135,7,58,No,5,9,406,65,290,522,35,63,0.11864406779661017,0.0847457627118644,2.0794415416798357,4.07753744390572
1607,4,83,No,8,0,332,87,664,0,32,91,0.047619047619047616,0.09523809523809523,1.6094379124341003,4.430816798843313
4774,6,70,No,7,1,420,76,490,70,42,77,0.08450704225352113,0.09859154929577464,1.9459101490553132,4.2626798770413155
8110,4,93,No,7,3,372,97,651,279,28,100,0.0425531914893617,0.07446808510638298,1.6094379124341003,4.543294782270004
6952,4,77,No,4,0,308,81,308,0,16,81,0.05128205128205128,0.05128205128205128,1.6094379124341003,4.356708826689592
6005,8,49,Yes,8,5,392,57,392,245,64,57,0.16,0.16,2.1972245773362196,3.912023005428146
7729,4,91,No,6,7,364,95,546,637,24,97,0.043478260869565216,0.06521739130434782,1.6094379124341003,4.5217885770490405
3542,1,49,No,5,7,49,50,245,343,5,54,0.02,0.1,0.6931471805599453,3.912023005428146
389,1,65,Yes,4,1,65,66,260,65,4,69,0.015151515151515152,0.06060606060606061,0.6931471805599453,4.189654742026425
1795,9,69,No,5,0,621,78,345,0,45,74,0.12857142857142856,0.07142857142857142,2.302585092994046,4.248495242049359
8732,9,79,No,4,5,711,88,316,395,36,83,0.1125,0.05,2.302585092994046,4.382026634673881
4920,3,65,Yes,8,0,195,68,520,0,24,73,0.045454545454545456,0.12121212121212122,1.3862943611198906,4.189654742026425
5538,5,60,Yes,5,9,300,65,300,540,25,65,0.08196721311475409,0.08196721311475409,1.791759469228055,4.110873864173311
3873,6,67,No,6,2,402,73,402,134,36,73,0.08823529411764706,0.08823529411764706,1.9459101490553132,4.219507705176107
8869,6,63,Yes,4,8,378,69,252,504,24,67,0.09375,0.0625,1.9459101490553132,4.1588830833596715
2255,4,95,Yes,9,5,380,99,855,475,36,104,0.041666666666666664,0.09375,1.6094379124341003,4.564348191467836
3413,8,62,No,9,8,496,70,558,496,72,71,0.12698412698412698,0.14285714285714285,2.1972245773362196,4.143134726391533
5460,4,65,No,4,0,260,69,260,0,16,69,0.06060606060606061,0.06060606060606061,1.6094379124341003,4.189654742026425
4956,9,71,No,7,5,639,80,497,355,63,78,0.125,0.09722222222222222,2.302585092994046,4.276666119016055
7397,1,91,No,4,3,91,92,364,273,4,95,0.010869565217391304,0.043478260869565216,0.6931471805599453,4.5217885770490405
5415,2,62,No,6,1,124,64,372,62,12,68,0.031746031746031744,0.09523809523809523,1.0986122886681098,4.143134726391533
7400,5,68,Yes,6,2,340,73,408,136,30,74,0.07246376811594203,0.08695652173913043,1.791759469228055,4.23410650459726
7415,5,83,No,6,5,415,88,498,415,30,89,0.05952380952380952,0.07142857142857142,1.791759469228055,4.430816798843313
9101,6,42,No,4,9,252,48,168,378,24,46,0.13953488372093023,0.09302325581395349,1.9459101490553132,3.7612001156935624
4852,6,71,No,6,6,426,77,426,426,36,77,0.08333333333333333,0.08333333333333333,1.9459101490553132,4.276666119016055
2026,8,76,No,6,8,608,84,456,608,48,82,0.1038961038961039,0.07792207792207792,2.1972245773362196,4.343805421853684
2616,3,88,Yes,8,6,264,91,704,528,24,96,0.033707865168539325,0.0898876404494382,1.3862943611198906,4.48863636973214
7389,1,61,Yes,6,6,61,62,366,366,6,67,0.016129032258064516,0.0967741935483871,0.6931471805599453,4.127134385045092
2927,8,90,No,5,4,720,98,450,360,40,95,0.08791208791208792,0.054945054945054944,2.1972245773362196,4.51085950651685
1122,2,67,Yes,9,3,134,69,603,201,18,76,0.029411764705882353,0.1323529411764706,1.0986122886681098,4.219507705176107
2911,4,94,Yes,4,5,376,98,376,470,16,98,0.042105263157894736,0.042105263157894736,1.6094379124341003,4.553876891600541
8147,8,68,Yes,4,5,544,76,272,340,32,72,0.11594202898550725,0.057971014492753624,2.1972245773362196,4.23410650459726
7384,1,69,Yes,4,3,69,70,276,207,4,73,0.014285714285714285,0.05714285714285714,0.6931471805599453,4.248495242049359
3483,9,87,No,7,3,783,96,609,261,63,94,0.10227272727272728,0.07954545454545454,2.302585092994046,4.477336814478207
796,5,40,No,4,9,200,45,160,360,20,44,0.12195121951219512,0.0975609756097561,1.791759469228055,3.713572066704308
1576,4,47,Yes,8,9,188,51,376,423,32,55,0.08333333333333333,0.16666666666666666,1.6094379124341003,3.871201010907891
6177,4,69,Yes,8,6,276,73,552,414,32,77,0.05714285714285714,0.11428571428571428,1.6094379124341003,4.248495242049359
6267,9,56,Yes,9,2,504,65,504,112,81,65,0.15789473684210525,0.15789473684210525,2.302585092994046,4.04305126783455
2459,3,60,No,8,1,180,63,480,60,24,68,0.04918032786885246,0.13114754098360656,1.3862943611198906,4.110873864173311
3313,8,46,No,4,8,368,54,184,368,32,50,0.1702127659574468,0.0851063829787234,2.1972245773362196,3.8501476017100584
1254,8,62,No,7,2,496,70,434,124,56,69,0.12698412698412698,0.1111111111111111,2.1972245773362196,4.143134726391533
6835,7,88,Yes,5,3,616,95,440,264,35,93,0.07865168539325842,0.056179775280898875,2.0794415416798357,4.48863636973214
8795,1,98,Yes,5,6,98,99,490,588,5,103,0.010101010101010102,0.050505050505050504,0.6931471805599453,4.59511985013459
3838,6,75,No,7,7,450,81,525,525,42,82,0.07894736842105263,0.09210526315789473,1.9459101490553132,4.330733340286331
4399,9,83,No,8,7,747,92,664,581,72,91,0.10714285714285714,0.09523809523809523,2.302585092994046,4.430816798843313
3596,8,60,Yes,7,9,480,68,420,540,56,67,0.13114754098360656,0.11475409836065574,2.1972245773362196,4.110873864173311
6622,7,61,No,8,0,427,68,488,0,56,69,0.11290322580645161,0.12903225806451613,2.0794415416798357,4.127134385045092
8383,6,84,No,4,6,504,90,336,504,24,88,0.07058823529411765,0.047058823529411764,1.9459101490553132,4.442651256490317
2125,5,73,Yes,7,5,365,78,511,365,35,80,0.06756756756756757,0.0945945945945946,1.791759469228055,4.30406509320417
3239,7,68,No,6,3,476,75,408,204,42,74,0.10144927536231885,0.08695652173913043,2.0794415416798357,4.23410650459726
5404,7,86,No,5,7,602,93,430,602,35,91,0.08045977011494253,0.05747126436781609,2.0794415416798357,4.465908118654584
5999,6,89,Yes,4,5,534,95,356,445,24,93,0.06666666666666667,0.044444444444444446,1.9459101490553132,4.499809670330265
5939,2,63,No,4,0,126,65,252,0,8,67,0.03125,0.0625,1.0986122886681098,4.1588830833596715
2046,1,47,No,8,9,47,48,376,423,8,55,0.020833333333333332,0.16666666666666666,0.6931471805599453,3.871201010907891
1579,9,45,No,4,9,405,54,180,405,36,49,0.1956521739130435,0.08695652173913043,2.302585092994046,3.828641396489095
15,5,79,No,7,8,395,84,553,632,35,86,0.0625,0.0875,1.791759469228055,4.382026634673881
2674,1,96,No,7,5,96,97,672,480,7,103,0.010309278350515464,0.07216494845360824,0.6931471805599453,4.574710978503383
7017,7,68,No,7,6,476,75,476,408,49,75,0.10144927536231885,0.10144927536231885,2.0794415416798357,4.23410650459726
8721,4,90,No,4,1,360,94,360,90,16,94,0.04395604395604396,0.04395604395604396,1.6094379124341003,4.51085950651685
8850,2,50,Yes,6,6,100,52,300,300,12,56,0.0392156862745098,0.11764705882352941,1.0986122886681098,3.9318256327243257
4813,2,43,No,5,6,86,45,215,258,10,48,0.045454545454545456,0.11363636363636363,1.0986122886681098,3.784189633918261
1085,6,76,Yes,6,9,456,82,456,684,36,82,0.07792207792207792,0.07792207792207792,1.9459101490553132,4.343805421853684
4984,6,58,No,9,7,348,64,522,406,54,67,0.1016949152542373,0.15254237288135594,1.9459101490553132,4.07753744390572
7156,8,82,No,8,3,656,90,656,246,64,90,0.0963855421686747,0.0963855421686747,2.1972245773362196,4.418840607796598
2885,3,90,No,6,5,270,93,540,450,18,96,0.03296703296703297,0.06593406593406594,1.3862943611198906,4.51085950651685
334,8,45,Yes,6,2,360,53,270,90,48,51,0.17391304347826086,0.13043478260869565,2.1972245773362196,3.828641396489095
7205,7,99,No,4,5,693,106,396,495,28,103,0.07,0.04,2.0794415416798357,4.605170185988092
4368,3,77,Yes,8,5,231,80,616,385,24,85,0.038461538461538464,0.10256410256410256,1.3862943611198906,4.356708826689592
3080,9,85,No,9,1,765,94,765,85,81,94,0.10465116279069768,0.10465116279069768,2.302585092994046,4.454347296253507
7204,5,71,Yes,4,6,355,76,284,426,20,75,0.06944444444444445,0.05555555555555555,1.791759469228055,4.276666119016055
9910,5,51,Yes,5,1,255,56,255,51,25,56,0.09615384615384616,0.09615384615384616,1.791759469228055,3.9512437185814275
8865,4,58,Yes,9,7,232,62,522,406,36,67,0.06779661016949153,0.15254237288135594,1.6094379124341003,4.07753744390572
264,8,56,Yes,5,6,448,64,280,336,40,61,0.14035087719298245,0.08771929824561403,2.1972245773362196,4.04305126783455
4338,1,68,Yes,7,4,68,69,476,272,7,75,0.014492753623188406,0.10144927536231885,0.6931471805599453,4.23410650459726
8896,3,53,Yes,4,2,159,56,212,106,12,57,0.05555555555555555,0.07407407407407407,1.3862943611198906,3.9889840465642745
8448,7,83,Yes,7,1,581,90,581,83,49,90,0.08333333333333333,0.08333333333333333,2.0794415416798357,4.430816798843313
5904,4,88,Yes,9,0,352,92,792,0,36,97,0.0449438202247191,0.10112359550561797,1.6094379124341003,4.48863636973214
1499,6,49,No,6,2,294,55,294,98,36,55,0.12,0.12,1.9459101490553132,3.912023005428146
4191,8,46,No,6,5,368,54,276,230,48,52,0.1702127659574468,0.1276595744680851,2.1972245773362196,3.8501476017100584
7486,4,51,No,5,3,204,55,255,153,20,56,0.07692307692307693,0.09615384615384616,1.6094379124341003,3.9512437185814275
9644,6,58,Yes,8,2,348,64,464,116,48,66,0.1016949152542373,0.13559322033898305,1.9459101490553132,4.07753744390572
8311,6,70,Yes,4,4,420,76,280,280,24,74,0.08450704225352113,0.056338028169014086,1.9459101490553132,4.2626798770413155
7591,3,69,No,7,5,207,72,483,345,21,76,0.04285714285714286,0.1,1.3862943611198906,4.248495242049359
501,3,51,No,6,4,153,54,306,204,18,57,0.057692307692307696,0.11538461538461539,1.3862943611198906,3.9512437185814275
9156,3,74,No,7,3,222,77,518,222,21,81,0.04,0.09333333333333334,1.3862943611198906,4.31748811353631
9415,2,96,No,6,7,192,98,576,672,12,102,0.020618556701030927,0.061855670103092786,1.0986122886681098,4.574710978503383
3096,5,80,Yes,7,5,400,85,560,400,35,87,0.06172839506172839,0.08641975308641975,1.791759469228055,4.394449154672439
4632,5,75,Yes,5,3,375,80,375,225,25,80,0.06578947368421052,0.06578947368421052,1.791759469228055,4.330733340286331
368,3,50,Yes,5,5,150,53,250,250,15,55,0.058823529411764705,0.09803921568627451,1.3862943611198906,3.9318256327243257
4059,9,66,No,8,5,594,75,528,330,72,74,0.13432835820895522,0.11940298507462686,2.302585092994046,4.204692619390966
8175,2,65,Yes,5,3,130,67,325,195,10,70,0.030303030303030304,0.07575757575757576,1.0986122886681098,4.189654742026425
4631,5,63,No,8,6,315,68,504,378,40,71,0.078125,0.125,1.791759469228055,4.1588830833596715
6071,2,78,Yes,6,4,156,80,468,312,12,84,0.02531645569620253,0.0759493670886076,1.0986122886681098,4.3694478524670215
2665,2,59,Yes,5,6,118,61,295,354,10,64,0.03333333333333333,0.08333333333333333,1.0986122886681098,4.0943445622221
1027,3,77,Yes,4,1,231,80,308,77,12,81,0.038461538461538464,0.05128205128205128,1.3862943611198906,4.356708826689592
5909,2,57,Yes,7,5,114,59,399,285,14,64,0.034482758620689655,0.1206896551724138,1.0986122886681098,4.060443010546419
5051,6,69,No,5,5,414,75,345,345,30,74,0.08571428571428572,0.07142857142857142,1.9459101490553132,4.248495242049359
6329,5,81,No,7,9,405,86,567,729,35,88,0.06097560975609756,0.08536585365853659,1.791759469228055,4.406719247264253
9734,5,99,Yes,9,3,495,104,891,297,45,108,0.05,0.09,1.791759469228055,4.605170185988092
1692,8,91,No,7,8,728,99,637,728,56,98,0.08695652173913043,0.07608695652173914,2.1972245773362196,4.5217885770490405
674,5,95,Yes,8,1,475,100,760,95,40,103,0.052083333333333336,0.08333333333333333,1.791759469228055,4.564348191467836
5573,6,59,No,8,0,354,65,472,0,48,67,0.1,0.13333333333333333,1.9459101490553132,4.0943445622221
5767,3,54,Yes,5,7,162,57,270,378,15,59,0.05454545454545454,0.09090909090909091,1.3862943611198906,4.007333185232471
5157,1,77,No,7,5,77,78,539,385,7,84,0.01282051282051282,0.08974358974358974,0.6931471805599453,4.356708826689592
734,2,61,Yes,8,0,122,63,488,0,16,69,0.03225806451612903,0.12903225806451613,1.0986122886681098,4.127134385045092
3527,2,40,No,4,0,80,42,160,0,8,44,0.04878048780487805,0.0975609756097561,1.0986122886681098,3.713572066704308
569,8,62,Yes,6,2,496,70,372,124,48,68,0.12698412698412698,0.09523809523809523,2.1972245773362196,4.143134726391533
9188,2,49,Yes,8,3,98,51,392,147,16,57,0.04,0.16,1.0986122886681098,3.912023005428146
2923,2,85,Yes,7,2,170,87,595,170,14,92,0.023255813953488372,0.08139534883720931,1.0986122886681098,4.454347296253507
7912,9,45,Yes,7,5,405,54,315,225,63,52,0.1956521739130435,0.15217391304347827,2.302585092994046,3.828641396489095
1559,1,40,Yes,9,6,40,41,360,240,9,49,0.024390243902439025,0.21951219512195122,0.6931471805599453,3.713572066704308
102,5,70,Yes,9,6,350,75,630,420,45,79,0.07042253521126761,0.1267605633802817,1.791759469228055,4.2626798770413155
3008,8,45,Yes,9,7,360,53,405,315,72,54,0.17391304347826086,0.1956521739130435,2.1972245773362196,3.828641396489095
7202,3,44,No,6,3,132,47,264,132,18,50,0.06666666666666667,0.13333333333333333,1.3862943611198906,3.8066624897703196
304,9,93,No,7,5,837,102,651,465,63,100,0.09574468085106383,0.07446808510638298,2.302585092994046,4.543294782270004
77,8,68,No,7,3,544,76,476,204,56,75,0.11594202898550725,0.10144927536231885,2.1972245773362196,4.23410650459726
6755,5,57,No,5,0,285,62,285,0,25,62,0.08620689655172414,0.08620689655172414,1.791759469228055,4.060443010546419
8630,6,84,Yes,8,8,504,90,672,672,48,92,0.07058823529411765,0.09411764705882353,1.9459101490553132,4.442651256490317
1209,5,94,No,8,8,470,99,752,752,40,102,0.05263157894736842,0.08421052631578947,1.791759469228055,4.553876891600541
7743,9,92,Yes,5,5,828,101,460,460,45,97,0.0967741935483871,0.053763440860215055,2.302585092994046,4.532599493153256
8215,9,87,No,7,9,783,96,609,783,63,94,0.10227272727272728,0.07954545454545454,2.302585092994046,4.477336814478207
8945,7,47,No,7,1,329,54,329,47,49,54,0.14583333333333334,0.14583333333333334,2.0794415416798357,3.871201010907891
8414,8,99,Yes,6,1,792,107,594,99,48,105,0.08,0.06,2.1972245773362196,4.605170185988092
1776,1,67,No,4,6,67,68,268,402,4,71,0.014705882352941176,0.058823529411764705,0.6931471805599453,4.219507705176107
3474,7,40,Yes,9,6,280,47,360,240,63,49,0.17073170731707318,0.21951219512195122,2.0794415416798357,3.713572066704308
484,9,90,No,5,8,810,99,450,720,45,95,0.0989010989010989,0.054945054945054944,2.302585092994046,4.51085950651685
2190,4,90,Yes,9,8,360,94,810,720,36,99,0.04395604395604396,0.0989010989010989,1.6094379124341003,4.51085950651685
347,1,40,Yes,8,9,40,41,320,360,8,48,0.024390243902439025,0.1951219512195122,0.6931471805599453,3.713572066704308
5482,9,85,No,5,2,765,94,425,170,45,90,0.10465116279069768,0.05813953488372093,2.302585092994046,4.454347296253507
8362,3,49,Yes,4,0,147,52,196,0,12,53,0.06,0.08,1.3862943611198906,3.912023005428146
1473,2,85,Yes,9,1,170,87,765,85,18,94,0.023255813953488372,0.10465116279069768,1.0986122886681098,4.454347296253507
5101,5,77,Yes,5,4,385,82,385,308,25,82,0.0641025641025641,0.0641025641025641,1.791759469228055,4.356708826689592
6766,9,44,Yes,4,8,396,53,176,352,36,48,0.2,0.08888888888888889,2.302585092994046,3.8066624897703196
8707,6,83,Yes,5,4,498,89,415,332,30,88,0.07142857142857142,0.05952380952380952,1.9459101490553132,4.430816798843313
4930,2,89,Yes,5,5,178,91,445,445,10,94,0.022222222222222223,0.05555555555555555,1.0986122886681098,4.499809670330265
6330,7,81,Yes,9,6,567,88,729,486,63,90,0.08536585365853659,0.10975609756097561,2.0794415416798357,4.406719247264253
2610,6,51,Yes,4,0,306,57,204,0,24,55,0.11538461538461539,0.07692307692307693,1.9459101490553132,3.9512437185814275
4,5,52,Yes,5,2,260,57,260,104,25,57,0.09433962264150944,0.09433962264150944,1.791759469228055,3.970291913552122
2214,3,47,Yes,4,1,141,50,188,47,12,51,0.0625,0.08333333333333333,1.3862943611198906,3.871201010907891
4828,2,89,No,8,1,178,91,712,89,16,97,0.022222222222222223,0.08888888888888889,1.0986122886681098,4.499809670330265
857,7,65,Yes,6,1,455,72,390,65,42,71,0.10606060606060606,0.09090909090909091,2.0794415416798357,4.189654742026425
6978,3,47,No,9,4,141,50,423,188,27,56,0.0625,0.1875,1.3862943611198906,3.871201010907891
5886,1,85,Yes,7,8,85,86,595,680,7,92,0.011627906976744186,0.08139534883720931,0.6931471805599453,4.454347296253507
625,7,54,Yes,4,5,378,61,216,270,28,58,0.12727272727272726,0.07272727272727272,2.0794415416798357,4.007333185232471
291,9,44,No,4,7,396,53,176,308,36,48,0.2,0.08888888888888889,2.302585092994046,3.8066624897703196
2019,8,76,Yes,6,5,608,84,456,380,48,82,0.1038961038961039,0.07792207792207792,2.1972245773362196,4.343805421853684
669,3,75,Yes,5,7,225,78,375,525,15,80,0.039473684210526314,0.06578947368421052,1.3862943611198906,4.330733340286331
8922,2,67,No,8,7,134,69,536,469,16,75,0.029411764705882353,0.11764705882352941,1.0986122886681098,4.219507705176107
8265,3,46,No,5,4,138,49,230,184,15,51,0.06382978723404255,0.10638297872340426,1.3862943611198906,3.8501476017100584
9697,2,63,No,5,3,126,65,315,189,10,68,0.03125,0.078125,1.0986122886681098,4.1588830833596715
1632,5,48,Yes,7,7,240,53,336,336,35,55,0.10204081632653061,0.14285714285714285,1.791759469228055,3.8918202981106265
5171,3,56,Yes,4,4,168,59,224,224,12,60,0.05263157894736842,0.07017543859649122,1.3862943611198906,4.04305126783455
7206,2,91,Yes,7,1,182,93,637,91,14,98,0.021739130434782608,0.07608695652173914,1.0986122886681098,4.5217885770490405
2523,9,50,Yes,7,5,450,59,350,250,63,57,0.17647058823529413,0.13725490196078433,2.302585092994046,3.9318256327243257
2216,7,62,Yes,4,7,434,69,248,434,28,66,0.1111111111111111,0.06349206349206349,2.0794415416798357,4.143134726391533
6969,3,63,Yes,9,5,189,66,567,315,27,72,0.046875,0.140625,1.3862943611198906,4.1588830833596715
6497,5,63,No,9,7,315,68,567,441,45,72,0.078125,0.140625,1.791759469228055,4.1588830833596715
6214,2,75,No,4,4,150,77,300,300,8,79,0.02631578947368421,0.05263157894736842,1.0986122886681098,4.330733340286331
7033,5,43,No,5,6,215,48,215,258,25,48,0.11363636363636363,0.11363636363636363,1.791759469228055,3.784189633918261
7421,1,51,Yes,8,8,51,52,408,408,8,59,0.019230769230769232,0.15384615384615385,0.6931471805599453,3.9512437185814275
1108,2,87,No,4,9,174,89,348,783,8,91,0.022727272727272728,0.045454545454545456,1.0986122886681098,4.477336814478207
451,9,84,No,6,6,756,93,504,504,54,90,0.10588235294117647,0.07058823529411765,2.302585092994046,4.442651256490317
6290,6,60,Yes,4,3,360,66,240,180,24,64,0.09836065573770492,0.06557377049180328,1.9459101490553132,4.110873864173311
9967,1,41,No,7,3,41,42,287,123,7,48,0.023809523809523808,0.16666666666666666,0.6931471805599453,3.7376696182833684
136,7,96,No,5,3,672,103,480,288,35,101,0.07216494845360824,0.05154639175257732,2.0794415416798357,4.574710978503383
1786,9,52,No,7,4,468,61,364,208,63,59,0.16981132075471697,0.1320754716981132,2.302585092994046,3.970291913552122
3405,3,72,Yes,5,0,216,75,360,0,15,77,0.0410958904109589,0.0684931506849315,1.3862943611198906,4.290459441148391
2907,8,78,No,7,0,624,86,546,0,56,85,0.10126582278481013,0.08860759493670886,2.1972245773362196,4.3694478524670215
8305,6,52,No,4,1,312,58,208,52,24,56,0.11320754716981132,0.07547169811320754,1.9459101490553132,3.970291913552122
7493,7,74,No,7,1,518,81,518,74,49,81,0.09333333333333334,0.09333333333333334,2.0794415416798357,4.31748811353631
6101,8,77,Yes,7,9,616,85,539,693,56,84,0.10256410256410256,0.08974358974358974,2.1972245773362196,4.356708826689592
4505,4,56,No,7,2,224,60,392,112,28,63,0.07017543859649122,0.12280701754385964,1.6094379124341003,4.04305126783455
5054,9,45,No,7,4,405,54,315,180,63,52,0.1956521739130435,0.15217391304347827,2.302585092994046,3.828641396489095
5206,1,76,Yes,7,3,76,77,532,228,7,83,0.012987012987012988,0.09090909090909091,0.6931471805599453,4.343805421853684
4081,9,46,No,6,2,414,55,276,92,54,52,0.19148936170212766,0.1276595744680851,2.302585092994046,3.8501476017100584
6919,4,47,Yes,7,0,188,51,329,0,28,54,0.08333333333333333,0.14583333333333334,1.6094379124341003,3.871201010907891
6803,2,94,No,7,8,188,96,658,752,14,101,0.021052631578947368,0.07368421052631578,1.0986122886681098,4.553876891600541
5207,8,51,No,5,2,408,59,255,102,40,56,0.15384615384615385,0.09615384615384616,2.1972245773362196,3.9512437185814275
533,1,90,Yes,5,5,90,91,450,450,5,95,0.01098901098901099,0.054945054945054944,0.6931471805599453,4.51085950651685
4831,2,82,Yes,6,6,164,84,492,492,12,88,0.024096385542168676,0.07228915662650602,1.0986122886681098,4.418840607796598
4039,9,66,No,9,3,594,75,594,198,81,75,0.13432835820895522,0.13432835820895522,2.302585092994046,4.204692619390966
4085,5,85,No,9,4,425,90,765,340,45,94,0.05813953488372093,0.10465116279069768,1.791759469228055,4.454347296253507
3205,8,47,No,9,5,376,55,423,235,72,56,0.16666666666666666,0.1875,2.1972245773362196,3.871201010907891
7111,3,98,No,5,9,294,101,490,882,15,103,0.030303030303030304,0.050505050505050504,1.3862943611198906,4.59511985013459
331,6,56,Yes,5,4,336,62,280,224,30,61,0.10526315789473684,0.08771929824561403,1.9459101490553132,4.04305126783455
4958,4,60,Yes,7,8,240,64,420,480,28,67,0.06557377049180328,0.11475409836065574,1.6094379124341003,4.110873864173311
3034,7,79,Yes,9,6,553,86,711,474,63,88,0.0875,0.1125,2.0794415416798357,4.382026634673881
7685,2,85,Yes,7,8,170,87,595,680,14,92,0.023255813953488372,0.08139534883720931,1.0986122886681098,4.454347296253507
1598,7,53,No,6,8,371,60,318,424,42,59,0.12962962962962962,0.1111111111111111,2.0794415416798357,3.9889840465642745
9920,5,90,No,9,7,450,95,810,630,45,99,0.054945054945054944,0.0989010989010989,1.791759469228055,4.51085950651685
3598,3,42,No,4,5,126,45,168,210,12,46,0.06976744186046512,0.09302325581395349,1.3862943611198906,3.7612001156935624
9039,5,82,Yes,6,7,410,87,492,574,30,88,0.060240963855421686,0.07228915662650602,1.791759469228055,4.418840607796598
8002,5,48,Yes,8,1,240,53,384,48,40,56,0.10204081632653061,0.16326530612244897,1.791759469228055,3.8918202981106265
591,3,67,Yes,8,6,201,70,536,402,24,75,0.04411764705882353,0.11764705882352941,1.3862943611198906,4.219507705176107
648,8,76,No,8,8,608,84,608,608,64,84,0.1038961038961039,0.1038961038961039,2.1972245773362196,4.343805421853684
9103,6,40,No,9,9,240,46,360,360,54,49,0.14634146341463414,0.21951219512195122,1.9459101490553132,3.713572066704308
8016,1,76,Yes,4,5,76,77,304,380,4,80,0.012987012987012988,0.05194805194805195,0.6931471805599453,4.343805421853684
3772,8,59,Yes,9,8,472,67,531,472,72,68,0.13333333333333333,0.15,2.1972245773362196,4.0943445622221
9040,3,73,No,6,4,219,76,438,292,18,79,0.04054054054054054,0.08108108108108109,1.3862943611198906,4.30406509320417
5083,2,57,Yes,7,0,114,59,399,0,14,64,0.034482758620689655,0.1206896551724138,1.0986122886681098,4.060443010546419
7883,9,91,Yes,4,5,819,100,364,455,36,95,0.09782608695652174,0.043478260869565216,2.302585092994046,4.5217885770490405
9363,2,66,No,9,5,132,68,594,330,18,75,0.029850746268656716,0.13432835820895522,1.0986122886681098,4.204692619390966
4211,9,88,No,6,7,792,97,528,616,54,94,0.10112359550561797,0.06741573033707865,2.302585092994046,4.48863636973214
8835,9,42,Yes,9,6,378,51,378,252,81,51,0.20930232558139536,0.20930232558139536,2.302585092994046,3.7612001156935624
8700,3,59,No,7,7,177,62,413,413,21,66,0.05,0.11666666666666667,1.3862943611198906,4.0943445622221
1796,1,56,No,6,2,56,57,336,112,6,62,0.017543859649122806,0.10526315789473684,0.6931471805599453,4.04305126783455
2587,9,67,Yes,5,6,603,76,335,402,45,72,0.1323529411764706,0.07352941176470588,2.302585092994046,4.219507705176107
8356,4,66,Yes,5,4,264,70,330,264,20,71,0.05970149253731343,0.07462686567164178,1.6094379124341003,4.204692619390966
2317,1,99,Yes,9,2,99,100,891,198,9,108,0.01,0.09,0.6931471805599453,4.605170185988092
4186,8,80,Yes,4,2,640,88,320,160,32,84,0.09876543209876543,0.04938271604938271,2.1972245773362196,4.394449154672439
8828,2,79,Yes,4,8,158,81,316,632,8,83,0.025,0.05,1.0986122886681098,4.382026634673881
7073,2,75,Yes,5,3,150,77,375,225,10,80,0.02631578947368421,0.06578947368421052,1.0986122886681098,4.330733340286331
5235,7,43,Yes,6,8,301,50,258,344,42,49,0.1590909090909091,0.13636363636363635,2.0794415416798357,3.784189633918261
8744,7,59,Yes,5,9,413,66,295,531,35,64,0.11666666666666667,0.08333333333333333,2.0794415416798357,4.0943445622221
8671,7,91,No,8,1,637,98,728,91,56,99,0.07608695652173914,0.08695652173913043,2.0794415416798357,4.5217885770490405
4769,4,64,No,7,3,256,68,448,192,28,71,0.06153846153846154,0.1076923076923077,1.6094379124341003,4.174387269895637
9973,4,75,No,6,3,300,79,450,225,24,81,0.05263157894736842,0.07894736842105263,1.6094379124341003,4.330733340286331
7145,6,80,No,7,3,480,86,560,240,42,87,0.07407407407407407,0.08641975308641975,1.9459101490553132,4.394449154672439
2914,8,79,No,8,8,632,87,632,632,64,87,0.1,0.1,2.1972245773362196,4.382026634673881
9872,8,77,Yes,5,8,616,85,385,616,40,82,0.10256410256410256,0.0641025641025641,2.1972245773362196,4.356708826689592
9894,8,82,Yes,6,5,656,90,492,410,48,88,0.0963855421686747,0.07228915662650602,2.1972245773362196,4.418840607796598
2076,4,51,Yes,5,8,204,55,255,408,20,56,0.07692307692307693,0.09615384615384616,1.6094379124341003,3.9512437185814275
4303,2,67,Yes,6,6,134,69,402,402,12,73,0.029411764705882353,0.08823529411764706,1.0986122886681098,4.219507705176107
5823,5,92,Yes,8,0,460,97,736,0,40,100,0.053763440860215055,0.08602150537634409,1.791759469228055,4.532599493153256
2150,3,41,No,4,1,123,44,164,41,12,45,0.07142857142857142,0.09523809523809523,1.3862943611198906,3.7376696182833684
145,8,48,No,5,4,384,56,240,192,40,53,0.16326530612244897,0.10204081632653061,2.1972245773362196,3.8918202981106265
4964,8,70,Yes,6,7,560,78,420,490,48,76,0.11267605633802817,0.08450704225352113,2.1972245773362196,4.2626798770413155
8160,8,65,No,4,8,520,73,260,520,32,69,0.12121212121212122,0.06060606060606061,2.1972245773362196,4.189654742026425
9031,4,93,Yes,7,1,372,97,651,93,28,100,0.0425531914893617,0.07446808510638298,1.6094379124341003,4.543294782270004
4776,7,92,No,9,7,644,99,828,644,63,101,0.07526881720430108,0.0967741935483871,2.0794415416798357,4.532599493153256
8934,3,57,No,7,6,171,60,399,342,21,64,0.05172413793103448,0.1206896551724138,1.3862943611198906,4.060443010546419
7750,2,65,No,6,0,130,67,390,0,12,71,0.030303030303030304,0.09090909090909091,1.0986122886681098,4.189654742026425
9829,6,91,Yes,9,4,546,97,819,364,54,100,0.06521739130434782,0.09782608695652174,1.9459101490553132,4.5217885770490405
9215,2,62,No,4,9,124,64,248,558,8,66,0.031746031746031744,0.06349206349206349,1.0986122886681098,4.143134726391533
6061,3,56,No,4,5,168,59,224,280,12,60,0.05263157894736842,0.07017543859649122,1.3862943611198906,4.04305126783455
9476,9,67,Yes,8,8,603,76,536,536,72,75,0.1323529411764706,0.11764705882352941,2.302585092994046,4.219507705176107
6410,3,73,Yes,6,9,219,76,438,657,18,79,0.04054054054054054,0.08108108108108109,1.3862943611198906,4.30406509320417
3318,9,52,No,6,5,468,61,312,260,54,58,0.16981132075471697,0.11320754716981132,2.302585092994046,3.970291913552122
7465,1,76,Yes,7,2,76,77,532,152,7,83,0.012987012987012988,0.09090909090909091,0.6931471805599453,4.343805421853684
3062,1,60,No,9,5,60,61,540,300,9,69,0.01639344262295082,0.14754098360655737,0.6931471805599453,4.110873864173311
1356,8,68,No,5,9,544,76,340,612,40,73,0.11594202898550725,0.07246376811594203,2.1972245773362196,4.23410650459726
4515,2,73,No,7,2,146,75,511,146,14,80,0.02702702702702703,0.0945945945945946,1.0986122886681098,4.30406509320417
5506,1,87,Yes,8,7,87,88,696,609,8,95,0.011363636363636364,0.09090909090909091,0.6931471805599453,4.477336814478207
5251,1,52,No,5,8,52,53,260,416,5,57,0.018867924528301886,0.09433962264150944,0.6931471805599453,3.970291913552122
4512,9,80,Yes,4,4,720,89,320,320,36,84,0.1111111111111111,0.04938271604938271,2.302585092994046,4.394449154672439
1731,9,92,Yes,7,3,828,101,644,276,63,99,0.0967741935483871,0.07526881720430108,2.302585092994046,4.532599493153256
1759,4,96,Yes,4,0,384,100,384,0,16,100,0.041237113402061855,0.041237113402061855,1.6094379124341003,4.574710978503383
6651,7,75,No,7,1,525,82,525,75,49,82,0.09210526315789473,0.09210526315789473,2.0794415416798357,4.330733340286331
6647,7,93,Yes,5,6,651,100,465,558,35,98,0.07446808510638298,0.05319148936170213,2.0794415416798357,4.543294782270004
9861,8,64,No,5,0,512,72,320,0,40,69,0.12307692307692308,0.07692307692307693,2.1972245773362196,4.174387269895637
4140,1,51,No,8,3,51,52,408,153,8,59,0.019230769230769232,0.15384615384615385,0.6931471805599453,3.9512437185814275
9394,5,83,Yes,5,6,415,88,415,498,25,88,0.05952380952380952,0.05952380952380952,1.791759469228055,4.430816798843313
5124,2,98,Yes,4,2,196,100,392,196,8,102,0.020202020202020204,0.04040404040404041,1.0986122886681098,4.59511985013459
1,7,99,Yes,9,1,693,106,891,99,63,108,0.07,0.09,2.0794415416798357,4.605170185988092
1865,8,56,No,9,3,448,64,504,168,72,65,0.14035087719298245,0.15789473684210525,2.1972245773362196,4.04305126783455
544,5,84,No,8,0,420,89,672,0,40,92,0.058823529411764705,0.09411764705882353,1.791759469228055,4.442651256490317
350,7,63,No,6,1,441,70,378,63,42,69,0.109375,0.09375,2.0794415416798357,4.1588830833596715
6907,3,56,Yes,6,4,168,59,336,224,18,62,0.05263157894736842,0.10526315789473684,1.3862943611198906,4.04305126783455
9766,5,56,No,8,0,280,61,448,0,40,64,0.08771929824561403,0.14035087719298245,1.791759469228055,4.04305126783455
2524,4,45,Yes,7,4,180,49,315,180,28,52,0.08695652173913043,0.15217391304347827,1.6094379124341003,3.828641396489095
3465,3,92,Yes,5,3,276,95,460,276,15,97,0.03225806451612903,0.053763440860215055,1.3862943611198906,4.532599493153256
458,9,67,Yes,4,3,603,76,268,201,36,71,0.1323529411764706,0.058823529411764705,2.302585092994046,4.219507705176107
3024,5,42,Yes,7,8,210,47,294,336,35,49,0.11627906976744186,0.16279069767441862,1.791759469228055,3.7612001156935624
7262,7,46,No,7,4,322,53,322,184,49,53,0.14893617021276595,0.14893617021276595,2.0794415416798357,3.8501476017100584
9516,4,90,Yes,5,5,360,94,450,450,20,95,0.04395604395604396,0.054945054945054944,1.6094379124341003,4.51085950651685
7873,6,94,Yes,7,7,564,100,658,658,42,101,0.06315789473684211,0.07368421052631578,1.9459101490553132,4.553876891600541
6626,5,98,Yes,8,3,490,103,784,294,40,106,0.050505050505050504,0.08080808080808081,1.791759469228055,4.59511985013459
2535,8,66,No,4,7,528,74,264,462,32,70,0.11940298507462686,0.05970149253731343,2.1972245773362196,4.204692619390966
132,9,89,Yes,5,3,801,98,445,267,45,94,0.1,0.05555555555555555,2.302585092994046,4.499809670330265
3705,7,41,Yes,9,0,287,48,369,0,63,50,0.16666666666666666,0.21428571428571427,2.0794415416798357,3.7376696182833684
1373,7,99,Yes,8,8,693,106,792,792,56,107,0.07,0.08,2.0794415416798357,4.605170185988092
6201,7,56,No,4,5,392,63,224,280,28,60,0.12280701754385964,0.07017543859649122,2.0794415416798357,4.04305126783455
4857,9,97,No,5,7,873,106,485,679,45,102,0.09183673469387756,0.05102040816326531,2.302585092994046,4.584967478670572
4713,4,59,Yes,8,0,236,63,472,0,32,67,0.06666666666666667,0.13333333333333333,1.6094379124341003,4.0943445622221
5545,4,76,No,7,9,304,80,532,684,28,83,0.05194805194805195,0.09090909090909091,1.6094379124341003,4.343805421853684
1414,4,66,No,6,7,264,70,396,462,24,72,0.05970149253731343,0.08955223880597014,1.6094379124341003,4.204692619390966
4114,6,89,Yes,8,9,534,95,712,801,48,97,0.06666666666666667,0.08888888888888889,1.9459101490553132,4.499809670330265
656,7,86,Yes,9,1,602,93,774,86,63,95,0.08045977011494253,0.10344827586206896,2.0794415416798357,4.465908118654584
8138,3,73,Yes,8,1,219,76,584,73,24,81,0.04054054054054054,0.10810810810810811,1.3862943611198906,4.30406509320417
4099,1,59,Yes,8,5,59,60,472,295,8,67,0.016666666666666666,0.13333333333333333,0.6931471805599453,4.0943445622221
593,7,85,No,8,7,595,92,680,595,56,93,0.08139534883720931,0.09302325581395349,2.0794415416798357,4.454347296253507
8709,5,94,Yes,7,8,470,99,658,752,35,101,0.05263157894736842,0.07368421052631578,1.791759469228055,4.553876891600541
3124,3,70,No,5,1,210,73,350,70,15,75,0.04225352112676056,0.07042253521126761,1.3862943611198906,4.2626798770413155
3048,7,94,Yes,4,2,658,101,376,188,28,98,0.07368421052631578,0.042105263157894736,2.0794415416798357,4.553876891600541
3888,2,66,No,9,4,132,68,594,264,18,75,0.029850746268656716,0.13432835820895522,1.0986122886681098,4.204692619390966
5736,7,56,Yes,8,3,392,63,448,168,56,64,0.12280701754385964,0.14035087719298245,2.0794415416798357,4.04305126783455
2185,7,45,Yes,7,2,315,52,315,90,49,52,0.15217391304347827,0.15217391304347827,2.0794415416798357,3.828641396489095
2146,3,61,Yes,8,3,183,64,488,183,24,69,0.04838709677419355,0.12903225806451613,1.3862943611198906,4.127134385045092
7048,9,46,Yes,4,4,414,55,184,184,36,50,0.19148936170212766,0.0851063829787234,2.302585092994046,3.8501476017100584
3106,7,65,Yes,8,2,455,72,520,130,56,73,0.10606060606060606,0.12121212121212122,2.0794415416798357,4.189654742026425
9234,8,74,Yes,8,1,592,82,592,74,64,82,0.10666666666666667,0.10666666666666667,2.1972245773362196,4.31748811353631
9097,4,88,No,9,7,352,92,792,616,36,97,0.0449438202247191,0.10112359550561797,1.6094379124341003,4.48863636973214
2770,5,47,No,7,9,235,52,329,423,35,54,0.10416666666666667,0.14583333333333334,1.791759469228055,3.871201010907891
5222,9,60,Yes,4,3,540,69,240,180,36,64,0.14754098360655737,0.06557377049180328,2.302585092994046,4.110873864173311
5834,4,50,Yes,5,8,200,54,250,400,20,55,0.0784313725490196,0.09803921568627451,1.6094379124341003,3.9318256327243257
1733,7,80,No,8,6,560,87,640,480,56,88,0.08641975308641975,0.09876543209876543,2.0794415416798357,4.394449154672439
266,5,68,No,4,8,340,73,272,544,20,72,0.07246376811594203,0.057971014492753624,1.791759469228055,4.23410650459726
5145,7,99,No,6,6,693,106,594,594,42,105,0.07,0.06,2.0794415416798357,4.605170185988092
8268,7,81,No,8,1,567,88,648,81,56,89,0.08536585365853659,0.0975609756097561,2.0794415416798357,4.406719247264253
3938,8,78,Yes,8,3,624,86,624,234,64,86,0.10126582278481013,0.10126582278481013,2.1972245773362196,4.3694478524670215
762,6,68,Yes,9,7,408,74,612,476,54,77,0.08695652173913043,0.13043478260869565,1.9459101490553132,4.23410650459726
7221,8,61,No,5,7,488,69,305,427,40,66,0.12903225806451613,0.08064516129032258,2.1972245773362196,4.127134385045092
8440,6,98,No,5,9,588,104,490,882,30,103,0.06060606060606061,0.050505050505050504,1.9459101490553132,4.59511985013459
3258,1,78,No,5,1,78,79,390,78,5,83,0.012658227848101266,0.06329113924050633,0.6931471805599453,4.3694478524670215
4339,6,62,Yes,8,5,372,68,496,310,48,70,0.09523809523809523,0.12698412698412698,1.9459101490553132,4.143134726391533
4363,7,67,Yes,5,2,469,74,335,134,35,72,0.10294117647058823,0.07352941176470588,2.0794415416798357,4.219507705176107
317,8,43,No,6,4,344,51,258,172,48,49,0.18181818181818182,0.13636363636363635,2.1972245773362196,3.784189633918261
8070,8,42,No,4,0,336,50,168,0,32,46,0.18604651162790697,0.09302325581395349,2.1972245773362196,3.7612001156935624
1852,8,62,Yes,5,6,496,70,310,372,40,67,0.12698412698412698,0.07936507936507936,2.1972245773362196,4.143134726391533
2485,6,45,No,4,5,270,51,180,225,24,49,0.13043478260869565,0.08695652173913043,1.9459101490553132,3.828641396489095
9874,4,69,Yes,4,1,276,73,276,69,16,73,0.05714285714285714,0.05714285714285714,1.6094379124341003,4.248495242049359
9575,5,65,No,9,6,325,70,585,390,45,74,0.07575757575757576,0.13636363636363635,1.791759469228055,4.189654742026425
1079,6,57,Yes,8,3,342,63,456,171,48,65,0.10344827586206896,0.13793103448275862,1.9459101490553132,4.060443010546419
8359,2,73,No,4,0,146,75,292,0,8,77,0.02702702702702703,0.05405405405405406,1.0986122886681098,4.30406509320417
7334,9,83,Yes,6,8,747,92,498,664,54,89,0.10714285714285714,0.07142857142857142,2.302585092994046,4.430816798843313
1072,4,82,Yes,8,6,328,86,656,492,32,90,0.04819277108433735,0.0963855421686747,1.6094379124341003,4.418840607796598
104,1,99,No,6,9,99,100,594,891,6,105,0.01,0.06,0.6931471805599453,4.605170185988092
5749,2,70,No,7,9,140,72,490,630,14,77,0.028169014084507043,0.09859154929577464,1.0986122886681098,4.2626798770413155
1419,6,62,No,5,7,372,68,310,434,30,67,0.09523809523809523,0.07936507936507936,1.9459101490553132,4.143134726391533
1659,9,52,Yes,7,6,468,61,364,312,63,59,0.16981132075471697,0.1320754716981132,2.302585092994046,3.970291913552122
5285,5,60,No,6,9,300,65,360,540,30,66,0.08196721311475409,0.09836065573770492,1.791759469228055,4.110873864173311
1150,3,58,No,7,0,174,61,406,0,21,65,0.05084745762711865,0.11864406779661017,1.3862943611198906,4.07753744390572
7151,8,54,No,4,2,432,62,216,108,32,58,0.14545454545454545,0.07272727272727272,2.1972245773362196,4.007333185232471
1569,4,51,Yes,9,0,204,55,459,0,36,60,0.07692307692307693,0.17307692307692307,1.6094379124341003,3.9512437185814275
1088,9,54,Yes,8,6,486,63,432,324,72,62,0.16363636363636364,0.14545454545454545,2.302585092994046,4.007333185232471
6086,3,89,No,9,3,267,92,801,267,27,98,0.03333333333333333,0.1,1.3862943611198906,4.499809670330265
8675,4,40,No,9,9,160,44,360,360,36,49,0.0975609756097561,0.21951219512195122,1.6094379124341003,3.713572066704308
8342,3,75,Yes,6,4,225,78,450,300,18,81,0.039473684210526314,0.07894736842105263,1.3862943611198906,4.330733340286331
7812,6,99,Yes,5,9,594,105,495,891,30,104,0.06,0.05,1.9459101490553132,4.605170185988092
6085,8,93,No,7,3,744,101,651,279,56,100,0.0851063829787234,0.07446808510638298,2.1972245773362196,4.543294782270004
8774,4,98,Yes,7,2,392,102,686,196,28,105,0.04040404040404041,0.0707070707070707,1.6094379124341003,4.59511985013459
8758,2,77,No,7,8,154,79,539,616,14,84,0.02564102564102564,0.08974358974358974,1.0986122886681098,4.356708826689592
1693,2,90,No,9,0,180,92,810,0,18,99,0.02197802197802198,0.0989010989010989,1.0986122886681098,4.51085950651685
4735,8,56,No,7,0,448,64,392,0,56,63,0.14035087719298245,0.12280701754385964,2.1972245773362196,4.04305126783455
3388,9,54,No,8,0,486,63,432,0,72,62,0.16363636363636364,0.14545454545454545,2.302585092994046,4.007333185232471
3647,4,75,No,8,9,300,79,600,675,32,83,0.05263157894736842,0.10526315789473684,1.6094379124341003,4.330733340286331
1684,3,68,No,7,9,204,71,476,612,21,75,0.043478260869565216,0.10144927536231885,1.3862943611198906,4.23410650459726
9,5,77,No,8,2,385,82,616,154,40,85,0.0641025641025641,0.10256410256410256,1.791759469228055,4.356708826689592
6063,3,71,No,4,5,213,74,284,355,12,75,0.041666666666666664,0.05555555555555555,1.3862943611198906,4.276666119016055
6517,1,46,Yes,4,7,46,47,184,322,4,50,0.02127659574468085,0.0851063829787234,0.6931471805599453,3.8501476017100584
4124,8,51,Yes,9,0,408,59,459,0,72,60,0.15384615384615385,0.17307692307692307,2.1972245773362196,3.9512437185814275
8730,1,51,Yes,8,0,51,52,408,0,8,59,0.019230769230769232,0.15384615384615385,0.6931471805599453,3.9512437185814275
6046,3,44,No,6,9,132,47,264,396,18,50,0.06666666666666667,0.13333333333333333,1.3862943611198906,3.8066624897703196
568,7,67,Yes,5,0,469,74,335,0,35,72,0.10294117647058823,0.07352941176470588,2.0794415416798357,4.219507705176107
9162,9,51,No,9,0,459,60,459,0,81,60,0.17307692307692307,0.17307692307692307,2.302585092994046,3.9512437185814275
1804,8,90,Yes,7,2,720,98,630,180,56,97,0.08791208791208792,0.07692307692307693,2.1972245773362196,4.51085950651685
8502,4,57,Yes,4,7,228,61,228,399,16,61,0.06896551724137931,0.06896551724137931,1.6094379124341003,4.060443010546419
4901,7,83,No,6,0,581,90,498,0,42,89,0.08333333333333333,0.07142857142857142,2.0794415416798357,4.430816798843313
1600,6,99,No,9,4,594,105,891,396,54,108,0.06,0.09,1.9459101490553132,4.605170185988092
7932,9,77,No,7,1,693,86,539,77,63,84,0.11538461538461539,0.08974358974358974,2.302585092994046,4.356708826689592
9548,5,60,No,7,0,300,65,420,0,35,67,0.08196721311475409,0.11475409836065574,1.791759469228055,4.110873864173311
2824,5,74,No,5,5,370,79,370,370,25,79,0.06666666666666667,0.06666666666666667,1.791759469228055,4.31748811353631
5468,6,97,Yes,5,4,582,103,485,388,30,102,0.061224489795918366,0.05102040816326531,1.9459101490553132,4.584967478670572
3530,3,78,Yes,5,8,234,81,390,624,15,83,0.0379746835443038,0.06329113924050633,1.3862943611198906,4.3694478524670215
8684,5,57,Yes,4,5,285,62,228,285,20,61,0.08620689655172414,0.06896551724137931,1.791759469228055,4.060443010546419
1156,6,83,Yes,7,1,498,89,581,83,42,90,0.07142857142857142,0.08333333333333333,1.9459101490553132,4.430816798843313
6548,9,51,No,6,1,459,60,306,51,54,57,0.17307692307692307,0.11538461538461539,2.302585092994046,3.9512437185814275
9089,2,79,No,6,6,158,81,474,474,12,85,0.025,0.075,1.0986122886681098,4.382026634673881
7621,9,93,Yes,8,3,837,102,744,279,72,101,0.09574468085106383,0.0851063829787234,2.302585092994046,4.543294782270004
8297,2,71,No,9,3,142,73,639,213,18,80,0.027777777777777776,0.125,1.0986122886681098,4.276666119016055
4541,2,66,Yes,4,0,132,68,264,0,8,70,0.029850746268656716,0.05970149253731343,1.0986122886681098,4.204692619390966
9135,5,88,No,6,9,440,93,528,792,30,94,0.056179775280898875,0.06741573033707865,1.791759469228055,4.48863636973214
6483,3,74,Yes,4,1,222,77,296,74,12,78,0.04,0.05333333333333334,1.3862943611198906,4.31748811353631
5827,8,45,Yes,9,9,360,53,405,405,72,54,0.17391304347826086,0.1956521739130435,2.1972245773362196,3.828641396489095
1191,7,70,Yes,8,4,490,77,560,280,56,78,0.09859154929577464,0.11267605633802817,2.0794415416798357,4.2626798770413155
7445,1,82,Yes,9,6,82,83,738,492,9,91,0.012048192771084338,0.10843373493975904,0.6931471805599453,4.418840607796598
8521,4,63,Yes,5,9,252,67,315,567,20,68,0.0625,0.078125,1.6094379124341003,4.1588830833596715
961,6,93,No,6,6,558,99,558,558,36,99,0.06382978723404255,0.06382978723404255,1.9459101490553132,4.543294782270004
7455,9,89,Yes,9,8,801,98,801,712,81,98,0.1,0.1,2.302585092994046,4.499809670330265
37,4,59,No,8,3,236,63,472,177,32,67,0.06666666666666667,0.13333333333333333,1.6094379124341003,4.0943445622221
7517,6,86,No,6,5,516,92,516,430,36,92,0.06896551724137931,0.06896551724137931,1.9459101490553132,4.465908118654584
7645,5,73,No,6,0,365,78,438,0,30,79,0.06756756756756757,0.08108108108108109,1.791759469228055,4.30406509320417
4439,3,77,No,7,3,231,80,539,231,21,84,0.038461538461538464,0.08974358974358974,1.3862943611198906,4.356708826689592
6162,3,67,Yes,4,6,201,70,268,402,12,71,0.04411764705882353,0.058823529411764705,1.3862943611198906,4.219507705176107
7745,9,79,No,9,2,711,88,711,158,81,88,0.1125,0.1125,2.302585092994046,4.382026634673881
9588,5,58,No,8,8,290,63,464,464,40,66,0.0847457627118644,0.13559322033898305,1.791759469228055,4.07753744390572
8120,4,57,No,5,4,228,61,285,228,20,62,0.06896551724137931,0.08620689655172414,1.6094379124341003,4.060443010546419
6968,6,68,Yes,9,5,408,74,612,340,54,77,0.08695652173913043,0.13043478260869565,1.9459101490553132,4.23410650459726
5719,5,83,No,5,7,415,88,415,581,25,88,0.05952380952380952,0.05952380952380952,1.791759469228055,4.430816798843313
578,1,50,Yes,6,2,50,51,300,100,6,56,0.0196078431372549,0.11764705882352941,0.6931471805599453,3.9318256327243257
9834,9,56,No,6,6,504,65,336,336,54,62,0.15789473684210525,0.10526315789473684,2.302585092994046,4.04305126783455
4103,9,96,No,7,1,864,105,672,96,63,103,0.09278350515463918,0.07216494845360824,2.302585092994046,4.574710978503383
7647,4,63,Yes,7,6,252,67,441,378,28,70,0.0625,0.109375,1.6094379124341003,4.1588830833596715
4152,9,97,Yes,6,2,873,106,582,194,54,103,0.09183673469387756,0.061224489795918366,2.302585092994046,4.584967478670572
3131,9,56,No,7,9,504,65,392,504,63,63,0.15789473684210525,0.12280701754385964,2.302585092994046,4.04305126783455
4891,9,57,Yes,8,3,513,66,456,171,72,65,0.15517241379310345,0.13793103448275862,2.302585092994046,4.060443010546419
9976,3,79,No,9,5,237,82,711,395,27,88,0.0375,0.1125,1.3862943611198906,4.382026634673881
7472,8,48,No,9,0,384,56,432,0,72,57,0.16326530612244897,0.1836734693877551,2.1972245773362196,3.8918202981106265
1834,3,86,Yes,4,0,258,89,344,0,12,90,0.034482758620689655,0.04597701149425287,1.3862943611198906,4.465908118654584
9149,5,99,Yes,9,3,495,104,891,297,45,108,0.05,0.09,1.791759469228055,4.605170185988092
4892,5,97,No,9,4,485,102,873,388,45,106,0.05102040816326531,0.09183673469387756,1.791759469228055,4.584967478670572
2288,5,47,No,8,8,235,52,376,376,40,55,0.10416666666666667,0.16666666666666666,1.791759469228055,3.871201010907891
1331,1,42,Yes,5,5,42,43,210,210,5,47,0.023255813953488372,0.11627906976744186,0.6931471805599453,3.7612001156935624
2772,7,91,No,8,7,637,98,728,637,56,99,0.07608695652173914,0.08695652173913043,2.0794415416798357,4.5217885770490405
3687,1,43,No,7,7,43,44,301,301,7,50,0.022727272727272728,0.1590909090909091,0.6931471805599453,3.784189633918261
8284,8,48,No,6,0,384,56,288,0,48,54,0.16326530612244897,0.12244897959183673,2.1972245773362196,3.8918202981106265
5929,2,48,Yes,8,8,96,50,384,384,16,56,0.04081632653061224,0.16326530612244897,1.0986122886681098,3.8918202981106265
638,8,97,Yes,7,5,776,105,679,485,56,104,0.08163265306122448,0.07142857142857142,2.1972245773362196,4.584967478670572
48,4,73,No,4,6,292,77,292,438,16,77,0.05405405405405406,0.05405405405405406,1.6094379124341003,4.30406509320417
2603,7,57,Yes,7,7,399,64,399,399,49,64,0.1206896551724138,0.1206896551724138,2.0794415416798357,4.060443010546419
1966,4,50,No,5,6,200,54,250,300,20,55,0.0784313725490196,0.09803921568627451,1.6094379124341003,3.9318256327243257
2169,7,46,No,6,4,322,53,276,184,42,52,0.14893617021276595,0.1276595744680851,2.0794415416798357,3.8501476017100584
5050,5,42,Yes,6,0,210,47,252,0,30,48,0.11627906976744186,0.13953488372093023,1.791759469228055,3.7612001156935624
3335,6,81,Yes,4,5,486,87,324,405,24,85,0.07317073170731707,0.04878048780487805,1.9459101490553132,4.406719247264253
3020,5,60,Yes,4,2,300,65,240,120,20,64,0.08196721311475409,0.06557377049180328,1.791759469228055,4.110873864173311
8765,7,40,No,8,8,280,47,320,320,56,48,0.17073170731707318,0.1951219512195122,2.0794415416798357,3.713572066704308
9177,9,41,Yes,4,9,369,50,164,369,36,45,0.21428571428571427,0.09523809523809523,2.302585092994046,3.7376696182833684
1361,4,47,Yes,7,5,188,51,329,235,28,54,0.08333333333333333,0.14583333333333334,1.6094379124341003,3.871201010907891
5799,2,70,No,7,0,140,72,490,0,14,77,0.028169014084507043,0.09859154929577464,1.0986122886681098,4.2626798770413155
9401,6,55,No,8,6,330,61,440,330,48,63,0.10714285714285714,0.14285714285714285,1.9459101490553132,4.02535169073515
3252,4,64,No,8,0,256,68,512,0,32,72,0.06153846153846154,0.12307692307692308,1.6094379124341003,4.174387269895637
6301,2,50,Yes,7,9,100,52,350,450,14,57,0.0392156862745098,0.13725490196078433,1.0986122886681098,3.9318256327243257
2252,5,55,Yes,4,9,275,60,220,495,20,59,0.08928571428571429,0.07142857142857142,1.791759469228055,4.02535169073515
6028,5,61,Yes,7,3,305,66,427,183,35,68,0.08064516129032258,0.11290322580645161,1.791759469228055,4.127134385045092
1176,2,44,No,6,1,88,46,264,44,12,50,0.044444444444444446,0.13333333333333333,1.0986122886681098,3.8066624897703196
8800,1,98,No,6,7,98,99,588,686,6,104,0.010101010101010102,0.06060606060606061,0.6931471805599453,4.59511985013459
3280,7,92,Yes,8,4,644,99,736,368,56,100,0.07526881720430108,0.08602150537634409,2.0794415416798357,4.532599493153256
2974,1,62,No,8,1,62,63,496,62,8,70,0.015873015873015872,0.12698412698412698,0.6931471805599453,4.143134726391533
3397,7,49,No,4,4,343,56,196,196,28,53,0.14,0.08,2.0794415416798357,3.912023005428146
6940,7,95,No,7,2,665,102,665,190,49,102,0.07291666666666667,0.07291666666666667,2.0794415416798357,4.564348191467836
966,7,73,Yes,8,2,511,80,584,146,56,81,0.0945945945945946,0.10810810810810811,2.0794415416798357,4.30406509320417
8575,3,43,No,4,9,129,46,172,387,12,47,0.06818181818181818,0.09090909090909091,1.3862943611198906,3.784189633918261
743,6,55,Yes,9,1,330,61,495,55,54,64,0.10714285714285714,0.16071428571428573,1.9459101490553132,4.02535169073515
7515,2,63,No,4,3,126,65,252,189,8,67,0.03125,0.0625,1.0986122886681098,4.1588830833596715
3315,7,64,Yes,8,6,448,71,512,384,56,72,0.1076923076923077,0.12307692307692308,2.0794415416798357,4.174387269895637
4899,6,88,No,7,5,528,94,616,440,42,95,0.06741573033707865,0.07865168539325842,1.9459101490553132,4.48863636973214
9341,7,57,No,8,2,399,64,456,114,56,65,0.1206896551724138,0.13793103448275862,2.0794415416798357,4.060443010546419
4673,1,49,Yes,4,5,49,50,196,245,4,53,0.02,0.08,0.6931471805599453,3.912023005428146
8619,1,80,Yes,7,4,80,81,560,320,7,87,0.012345679012345678,0.08641975308641975,0.6931471805599453,4.394449154672439
1218,1,57,Yes,9,8,57,58,513,456,9,66,0.017241379310344827,0.15517241379310345,0.6931471805599453,4.060443010546419
4398,7,58,Yes,7,9,406,65,406,522,49,65,0.11864406779661017,0.11864406779661017,2.0794415416798357,4.07753744390572
6081,2,57,No,5,5,114,59,285,285,10,62,0.034482758620689655,0.08620689655172414,1.0986122886681098,4.060443010546419
2615,1,87,Yes,4,4,87,88,348,348,4,91,0.011363636363636364,0.045454545454545456,0.6931471805599453,4.477336814478207
2621,1,63,No,6,0,63,64,378,0,6,69,0.015625,0.09375,0.6931471805599453,4.1588830833596715
8715,8,59,Yes,6,4,472,67,354,236,48,65,0.13333333333333333,0.1,2.1972245773362196,4.0943445622221
7283,2,95,No,6,8,190,97,570,760,12,101,0.020833333333333332,0.0625,1.0986122886681098,4.564348191467836
3380,6,95,Yes,7,3,570,101,665,285,42,102,0.0625,0.07291666666666667,1.9459101490553132,4.564348191467836
7302,5,76,Yes,9,1,380,81,684,76,45,85,0.06493506493506493,0.11688311688311688,1.791759469228055,4.343805421853684
9858,6,54,Yes,9,5,324,60,486,270,54,63,0.10909090909090909,0.16363636363636364,1.9459101490553132,4.007333185232471
5606,7,78,No,5,0,546,85,390,0,35,83,0.08860759493670886,0.06329113924050633,2.0794415416798357,4.3694478524670215
9814,2,90,Yes,5,0,180,92,450,0,10,95,0.02197802197802198,0.054945054945054944,1.0986122886681098,4.51085950651685
5787,2,40,No,7,9,80,42,280,360,14,47,0.04878048780487805,0.17073170731707318,1.0986122886681098,3.713572066704308
8519,8,60,Yes,7,1,480,68,420,60,56,67,0.13114754098360656,0.11475409836065574,2.1972245773362196,4.110873864173311
6851,5,84,No,6,9,420,89,504,756,30,90,0.058823529411764705,0.07058823529411765,1.791759469228055,4.442651256490317
1517,4,50,Yes,8,5,200,54,400,250,32,58,0.0784313725490196,0.1568627450980392,1.6094379124341003,3.9318256327243257
5099,9,51,No,7,1,459,60,357,51,63,58,0.17307692307692307,0.1346153846153846,2.302585092994046,3.9512437185814275
7637,1,53,Yes,9,6,53,54,477,318,9,62,0.018518518518518517,0.16666666666666666,0.6931471805599453,3.9889840465642745
9086,7,45,No,8,8,315,52,360,360,56,53,0.15217391304347827,0.17391304347826086,2.0794415416798357,3.828641396489095
8024,7,65,Yes,6,3,455,72,390,195,42,71,0.10606060606060606,0.09090909090909091,2.0794415416798357,4.189654742026425
2393,8,92,Yes,7,8,736,100,644,736,56,99,0.08602150537634409,0.07526881720430108,2.1972245773362196,4.532599493153256
587,1,61,No,6,5,61,62,366,305,6,67,0.016129032258064516,0.0967741935483871,0.6931471805599453,4.127134385045092
3520,3,48,Yes,7,0,144,51,336,0,21,55,0.061224489795918366,0.14285714285714285,1.3862943611198906,3.8918202981106265
7654,5,48,No,8,8,240,53,384,384,40,56,0.10204081632653061,0.16326530612244897,1.791759469228055,3.8918202981106265
8947,2,54,Yes,8,9,108,56,432,486,16,62,0.03636363636363636,0.14545454545454545,1.0986122886681098,4.007333185232471
851,7,66,No,8,1,462,73,528,66,56,74,0.1044776119402985,0.11940298507462686,2.0794415416798357,4.204692619390966
336,5,96,Yes,4,6,480,101,384,576,20,100,0.05154639175257732,0.041237113402061855,1.791759469228055,4.574710978503383
6635,2,86,Yes,8,0,172,88,688,0,16,94,0.022988505747126436,0.09195402298850575,1.0986122886681098,4.465908118654584
8973,9,45,No,7,9,405,54,315,405,63,52,0.1956521739130435,0.15217391304347827,2.302585092994046,3.828641396489095
7494,9,66,Yes,5,3,594,75,330,198,45,71,0.13432835820895522,0.07462686567164178,2.302585092994046,4.204692619390966
2869,3,95,No,9,0,285,98,855,0,27,104,0.03125,0.09375,1.3862943611198906,4.564348191467836
4873,2,42,No,5,9,84,44,210,378,10,47,0.046511627906976744,0.11627906976744186,1.0986122886681098,3.7612001156935624
3551,9,55,No,8,8,495,64,440,440,72,63,0.16071428571428573,0.14285714285714285,2.302585092994046,4.02535169073515
3843,7,44,Yes,5,7,308,51,220,308,35,49,0.15555555555555556,0.1111111111111111,2.0794415416798357,3.8066624897703196
7263,5,72,Yes,6,5,360,77,432,360,30,78,0.0684931506849315,0.0821917808219178,1.791759469228055,4.290459441148391
5825,4,83,No,4,5,332,87,332,415,16,87,0.047619047619047616,0.047619047619047616,1.6094379124341003,4.430816798843313
24,1,85,No,5,6,85,86,425,510,5,90,0.011627906976744186,0.05813953488372093,0.6931471805599453,4.454347296253507
1454,1,90,Yes,9,3,90,91,810,270,9,99,0.01098901098901099,0.0989010989010989,0.6931471805599453,4.51085950651685
1685,9,49,No,8,7,441,58,392,343,72,57,0.18,0.16,2.302585092994046,3.912023005428146
2311,3,91,Yes,8,5,273,94,728,455,24,99,0.03260869565217391,0.08695652173913043,1.3862943611198906,4.5217885770490405
9064,5,40,Yes,4,5,200,45,160,200,20,44,0.12195121951219512,0.0975609756097561,1.791759469228055,3.713572066704308
9407,3,78,No,5,6,234,81,390,468,15,83,0.0379746835443038,0.06329113924050633,1.3862943611198906,4.3694478524670215
382,7,85,No,9,8,595,92,765,680,63,94,0.08139534883720931,0.10465116279069768,2.0794415416798357,4.454347296253507
5815,7,84,Yes,4,8,588,91,336,672,28,88,0.08235294117647059,0.047058823529411764,2.0794415416798357,4.442651256490317
5551,3,83,Yes,4,3,249,86,332,249,12,87,0.03571428571428571,0.047619047619047616,1.3862943611198906,4.430816798843313
9309,7,45,Yes,6,6,315,52,270,270,42,51,0.15217391304347827,0.13043478260869565,2.0794415416798357,3.828641396489095
1619,6,66,Yes,6,3,396,72,396,198,36,72,0.08955223880597014,0.08955223880597014,1.9459101490553132,4.204692619390966
790,7,90,Yes,4,9,630,97,360,810,28,94,0.07692307692307693,0.04395604395604396,2.0794415416798357,4.51085950651685
5984,8,40,No,7,7,320,48,280,280,56,47,0.1951219512195122,0.17073170731707318,2.1972245773362196,3.713572066704308
8673,4,87,Yes,5,9,348,91,435,783,20,92,0.045454545454545456,0.056818181818181816,1.6094379124341003,4.477336814478207
4476,2,89,No,4,7,178,91,356,623,8,93,0.022222222222222223,0.044444444444444446,1.0986122886681098,4.499809670330265
5607,1,58,No,6,8,58,59,348,464,6,64,0.01694915254237288,0.1016949152542373,0.6931471805599453,4.07753744390572
9313,5,47,No,4,9,235,52,188,423,20,51,0.10416666666666667,0.08333333333333333,1.791759469228055,3.871201010907891
5649,8,94,No,8,6,752,102,752,564,64,102,0.08421052631578947,0.08421052631578947,2.1972245773362196,4.553876891600541
6217,7,64,Yes,7,0,448,71,448,0,49,71,0.1076923076923077,0.1076923076923077,2.0794415416798357,4.174387269895637
2287,9,93,Yes,9,6,837,102,837,558,81,102,0.09574468085106383,0.09574468085106383,2.302585092994046,4.543294782270004
9994,9,58,Yes,7,7,522,67,406,406,63,65,0.15254237288135594,0.11864406779661017,2.302585092994046,4.07753744390572
7579,6,87,Yes,5,7,522,93,435,609,30,92,0.06818181818181818,0.056818181818181816,1.9459101490553132,4.477336814478207
1184,3,89,Yes,7,8,267,92,623,712,21,96,0.03333333333333333,0.07777777777777778,1.3862943611198906,4.499809670330265
6002,4,95,No,9,1,380,99,855,95,36,104,0.041666666666666664,0.09375,1.6094379124341003,4.564348191467836
5091,1,47,No,8,1,47,48,376,47,8,55,0.020833333333333332,0.16666666666666666,0.6931471805599453,3.871201010907891
2517,6,52,Yes,8,9,312,58,416,468,48,60,0.11320754716981132,0.1509433962264151,1.9459101490553132,3.970291913552122
4123,8,44,No,5,8,352,52,220,352,40,49,0.17777777777777778,0.1111111111111111,2.1972245773362196,3.8066624897703196
5522,8,64,Yes,6,3,512,72,384,192,48,70,0.12307692307692308,0.09230769230769231,2.1972245773362196,4.174387269895637
5628,3,98,Yes,7,4,294,101,686,392,21,105,0.030303030303030304,0.0707070707070707,1.3862943611198906,4.59511985013459
8361,6,81,No,4,8,486,87,324,648,24,85,0.07317073170731707,0.04878048780487805,1.9459101490553132,4.406719247264253
5873,2,96,No,8,2,192,98,768,192,16,104,0.020618556701030927,0.08247422680412371,1.0986122886681098,4.574710978503383
8613,8,64,No,6,1,512,72,384,64,48,70,0.12307692307692308,0.09230769230769231,2.1972245773362196,4.174387269895637
7728,7,50,No,9,5,350,57,450,250,63,59,0.13725490196078433,0.17647058823529413,2.0794415416798357,3.9318256327243257
5969,1,70,Yes,4,0,70,71,280,0,4,74,0.014084507042253521,0.056338028169014086,0.6931471805599453,4.2626798770413155
1181,7,69,Yes,6,9,483,76,414,621,42,75,0.1,0.08571428571428572,2.0794415416798357,4.248495242049359
8763,8,70,Yes,8,1,560,78,560,70,64,78,0.11267605633802817,0.11267605633802817,2.1972245773362196,4.2626798770413155
8236,6,41,No,4,1,246,47,164,41,24,45,0.14285714285714285,0.09523809523809523,1.9459101490553132,3.7376696182833684
2819,1,62,Yes,7,6,62,63,434,372,7,69,0.015873015873015872,0.1111111111111111,0.6931471805599453,4.143134726391533
9965,9,66,No,9,0,594,75,594,0,81,75,0.13432835820895522,0.13432835820895522,2.302585092994046,4.204692619390966
8704,8,61,No,6,1,488,69,366,61,48,67,0.12903225806451613,0.0967741935483871,2.1972245773362196,4.127134385045092
6609,5,67,No,6,6,335,72,402,402,30,73,0.07352941176470588,0.08823529411764706,1.791759469228055,4.219507705176107
2821,4,75,Yes,4,1,300,79,300,75,16,79,0.05263157894736842,0.05263157894736842,1.6094379124341003,4.330733340286331
7536,8,81,Yes,6,1,648,89,486,81,48,87,0.0975609756097561,0.07317073170731707,2.1972245773362196,4.406719247264253
2261,8,53,No,8,2,424,61,424,106,64,61,0.14814814814814814,0.14814814814814814,2.1972245773362196,3.9889840465642745
2240,6,78,Yes,8,6,468,84,624,468,48,86,0.0759493670886076,0.10126582278481013,1.9459101490553132,4.3694478524670215
6022,9,76,No,6,2,684,85,456,152,54,82,0.11688311688311688,0.07792207792207792,2.302585092994046,4.343805421853684
783,4,75,No,6,5,300,79,450,375,24,81,0.05263157894736842,0.07894736842105263,1.6094379124341003,4.330733340286331
933,6,64,No,7,9,384,70,448,576,42,71,0.09230769230769231,0.1076923076923077,1.9459101490553132,4.174387269895637
6203,8,47,Yes,6,9,376,55,282,423,48,53,0.16666666666666666,0.125,2.1972245773362196,3.871201010907891
2413,4,50,Yes,7,3,200,54,350,150,28,57,0.0784313725490196,0.13725490196078433,1.6094379124341003,3.9318256327243257
6998,5,70,No,5,3,350,75,350,210,25,75,0.07042253521126761,0.07042253521126761,1.791759469228055,4.2626798770413155
9116,3,74,Yes,4,1,222,77,296,74,12,78,0.04,0.05333333333333334,1.3862943611198906,4.31748811353631
1157,6,57,Yes,4,9,342,63,228,513,24,61,0.10344827586206896,0.06896551724137931,1.9459101490553132,4.060443010546419
8108,7,55,Yes,8,1,385,62,440,55,56,63,0.125,0.14285714285714285,2.0794415416798357,4.02535169073515
5806,6,65,No,4,0,390,71,260,0,24,69,0.09090909090909091,0.06060606060606061,1.9459101490553132,4.189654742026425
4880,4,88,No,5,6,352,92,440,528,20,93,0.0449438202247191,0.056179775280898875,1.6094379124341003,4.48863636973214
3310,1,83,Yes,4,2,83,84,332,166,4,87,0.011904761904761904,0.047619047619047616,0.6931471805599453,4.430816798843313
8962,4,70,Yes,7,0,280,74,490,0,28,77,0.056338028169014086,0.09859154929577464,1.6094379124341003,4.2626798770413155
1703,2,54,Yes,8,6,108,56,432,324,16,62,0.03636363636363636,0.14545454545454545,1.0986122886681098,4.007333185232471
2493,1,52,Yes,9,6,52,53,468,312,9,61,0.018867924528301886,0.16981132075471697,0.6931471805599453,3.970291913552122
3707,3,97,Yes,6,1,291,100,582,97,18,103,0.030612244897959183,0.061224489795918366,1.3862943611198906,4.584967478670572
8277,5,68,Yes,7,7,340,73,476,476,35,75,0.07246376811594203,0.10144927536231885,1.791759469228055,4.23410650459726
287,7,40,Yes,6,2,280,47,240,80,42,46,0.17073170731707318,0.14634146341463414,2.0794415416798357,3.713572066704308
1609,2,97,No,5,9,194,99,485,873,10,102,0.02040816326530612,0.05102040816326531,1.0986122886681098,4.584967478670572
6632,2,85,No,5,1,170,87,425,85,10,90,0.023255813953488372,0.05813953488372093,1.0986122886681098,4.454347296253507
8279,2,81,No,4,6,162,83,324,486,8,85,0.024390243902439025,0.04878048780487805,1.0986122886681098,4.406719247264253
7316,1,62,Yes,5,4,62,63,310,248,5,67,0.015873015873015872,0.07936507936507936,0.6931471805599453,4.143134726391533
2253,4,78,Yes,7,8,312,82,546,624,28,85,0.05063291139240506,0.08860759493670886,1.6094379124341003,4.3694478524670215
7416,7,82,Yes,5,4,574,89,410,328,35,87,0.08433734939759036,0.060240963855421686,2.0794415416798357,4.418840607796598
8366,7,56,Yes,9,4,392,63,504,224,63,65,0.12280701754385964,0.15789473684210525,2.0794415416798357,4.04305126783455
1892,6,72,No,5,8,432,78,360,576,30,77,0.0821917808219178,0.0684931506849315,1.9459101490553132,4.290459441148391
5063,2,63,Yes,4,6,126,65,252,378,8,67,0.03125,0.0625,1.0986122886681098,4.1588830833596715
6121,6,60,Yes,7,4,360,66,420,240,42,67,0.09836065573770492,0.11475409836065574,1.9459101490553132,4.110873864173311
564,2,81,No,5,2,162,83,405,162,10,86,0.024390243902439025,0.06097560975609756,1.0986122886681098,4.406719247264253
292,6,96,No,9,6,576,102,864,576,54,105,0.061855670103092786,0.09278350515463918,1.9459101490553132,4.574710978503383
4717,4,57,Yes,8,1,228,61,456,57,32,65,0.06896551724137931,0.13793103448275862,1.6094379124341003,4.060443010546419
7709,5,94,No,9,2,470,99,846,188,45,103,0.05263157894736842,0.09473684210526316,1.791759469228055,4.553876891600541
6350,7,77,No,8,8,539,84,616,616,56,85,0.08974358974358974,0.10256410256410256,2.0794415416798357,4.356708826689592
170,6,90,No,7,0,540,96,630,0,42,97,0.06593406593406594,0.07692307692307693,1.9459101490553132,4.51085950651685
268,1,82,No,4,6,82,83,328,492,4,86,0.012048192771084338,0.04819277108433735,0.6931471805599453,4.418840607796598
4639,4,92,No,9,5,368,96,828,460,36,101,0.043010752688172046,0.0967741935483871,1.6094379124341003,4.532599493153256
7078,5,47,No,8,4,235,52,376,188,40,55,0.10416666666666667,0.16666666666666666,1.791759469228055,3.871201010907891
3356,7,42,Yes,6,3,294,49,252,126,42,48,0.16279069767441862,0.13953488372093023,2.0794415416798357,3.7612001156935624
8280,8,45,Yes,6,1,360,53,270,45,48,51,0.17391304347826086,0.13043478260869565,2.1972245773362196,3.828641396489095
316,1,61,No,8,3,61,62,488,183,8,69,0.016129032258064516,0.12903225806451613,0.6931471805599453,4.127134385045092
6729,2,69,Yes,5,2,138,71,345,138,10,74,0.02857142857142857,0.07142857142857142,1.0986122886681098,4.248495242049359
9496,1,60,No,6,1,60,61,360,60,6,66,0.01639344262295082,0.09836065573770492,0.6931471805599453,4.110873864173311
4068,4,62,No,6,7,248,66,372,434,24,68,0.06349206349206349,0.09523809523809523,1.6094379124341003,4.143134726391533
246,4,78,No,8,3,312,82,624,234,32,86,0.05063291139240506,0.10126582278481013,1.6094379124341003,4.3694478524670215
253,3,79,Yes,7,5,237,82,553,395,21,86,0.0375,0.0875,1.3862943611198906,4.382026634673881
1112,6,91,Yes,8,9,546,97,728,819,48,99,0.06521739130434782,0.08695652173913043,1.9459101490553132,4.5217885770490405
4802,2,99,Yes,5,2,198,101,495,198,10,104,0.02,0.05,1.0986122886681098,4.605170185988092
1714,4,40,Yes,6,6,160,44,240,240,24,46,0.0975609756097561,0.14634146341463414,1.6094379124341003,3.713572066704308
51,4,44,Yes,7,6,176,48,308,264,28,51,0.08888888888888889,0.15555555555555556,1.6094379124341003,3.8066624897703196
1836,7,90,Yes,5,7,630,97,450,630,35,95,0.07692307692307693,0.054945054945054944,2.0794415416798357,4.51085950651685
7897,9,44,Yes,5,6,396,53,220,264,45,49,0.2,0.1111111111111111,2.302585092994046,3.8066624897703196
3384,9,64,Yes,9,5,576,73,576,320,81,73,0.13846153846153847,0.13846153846153847,2.302585092994046,4.174387269895637
6411,6,78,Yes,4,2,468,84,312,156,24,82,0.0759493670886076,0.05063291139240506,1.9459101490553132,4.3694478524670215
4314,2,84,No,9,8,168,86,756,672,18,93,0.023529411764705882,0.10588235294117647,1.0986122886681098,4.442651256490317
873,8,96,No,4,3,768,104,384,288,32,100,0.08247422680412371,0.041237113402061855,2.1972245773362196,4.574710978503383
1255,6,85,No,4,3,510,91,340,255,24,89,0.06976744186046512,0.046511627906976744,1.9459101490553132,4.454347296253507
8882,6,68,Yes,6,4,408,74,408,272,36,74,0.08695652173913043,0.08695652173913043,1.9459101490553132,4.23410650459726
5852,8,69,Yes,5,5,552,77,345,345,40,74,0.11428571428571428,0.07142857142857142,2.1972245773362196,4.248495242049359
5703,6,91,Yes,9,7,546,97,819,637,54,100,0.06521739130434782,0.09782608695652174,1.9459101490553132,4.5217885770490405
8104,9,98,Yes,8,9,882,107,784,882,72,106,0.09090909090909091,0.08080808080808081,2.302585092994046,4.59511985013459
2099,6,40,Yes,4,4,240,46,160,160,24,44,0.14634146341463414,0.0975609756097561,1.9459101490553132,3.713572066704308
5129,3,84,Yes,5,4,252,87,420,336,15,89,0.03529411764705882,0.058823529411764705,1.3862943611198906,4.442651256490317
249,4,63,No,7,0,252,67,441,0,28,70,0.0625,0.109375,1.6094379124341003,4.1588830833596715
6562,9,68,No,8,2,612,77,544,136,72,76,0.13043478260869565,0.11594202898550725,2.302585092994046,4.23410650459726
1340,7,63,No,6,1,441,70,378,63,42,69,0.109375,0.09375,2.0794415416798357,4.1588830833596715
7018,9,61,No,4,8,549,70,244,488,36,65,0.14516129032258066,0.06451612903225806,2.302585092994046,4.127134385045092
2111,9,67,Yes,7,4,603,76,469,268,63,74,0.1323529411764706,0.10294117647058823,2.302585092994046,4.219507705176107
1570,7,94,No,9,1,658,101,846,94,63,103,0.07368421052631578,0.09473684210526316,2.0794415416798357,4.553876891600541
1727,2,92,No,4,1,184,94,368,92,8,96,0.021505376344086023,0.043010752688172046,1.0986122886681098,4.532599493153256
8385,9,58,No,8,7,522,67,464,406,72,66,0.15254237288135594,0.13559322033898305,2.302585092994046,4.07753744390572
6941,8,74,Yes,4,9,592,82,296,666,32,78,0.10666666666666667,0.05333333333333334,2.1972245773362196,4.31748811353631
4396,8,47,Yes,6,8,376,55,282,376,48,53,0.16666666666666666,0.125,2.1972245773362196,3.871201010907891
2421,5,88,Yes,7,5,440,93,616,440,35,95,0.056179775280898875,0.07865168539325842,1.791759469228055,4.48863636973214
3046,1,57,No,8,3,57,58,456,171,8,65,0.017241379310344827,0.13793103448275862,0.6931471805599453,4.060443010546419
5504,7,47,Yes,4,7,329,54,188,329,28,51,0.14583333333333334,0.08333333333333333,2.0794415416798357,3.871201010907891
3704,7,72,Yes,5,8,504,79,360,576,35,77,0.0958904109589041,0.0684931506849315,2.0794415416798357,4.290459441148391
8192,8,90,Yes,7,5,720,98,630,450,56,97,0.08791208791208792,0.07692307692307693,2.1972245773362196,4.51085950651685
5332,8,45,No,9,0,360,53,405,0,72,54,0.17391304347826086,0.1956521739130435,2.1972245773362196,3.828641396489095
9809,3,80,No,6,1,240,83,480,80,18,86,0.037037037037037035,0.07407407407407407,1.3862943611198906,4.394449154672439
448,1,82,Yes,9,4,82,83,738,328,9,91,0.012048192771084338,0.10843373493975904,0.6931471805599453,4.418840607796598
7895,3,73,No,8,4,219,76,584,292,24,81,0.04054054054054054,0.10810810810810811,1.3862943611198906,4.30406509320417
8729,6,98,Yes,6,4,588,104,588,392,36,104,0.06060606060606061,0.06060606060606061,1.9459101490553132,4.59511985013459
7829,8,84,Yes,8,8,672,92,672,672,64,92,0.09411764705882353,0.09411764705882353,2.1972245773362196,4.442651256490317
1769,1,76,Yes,8,0,76,77,608,0,8,84,0.012987012987012988,0.1038961038961039,0.6931471805599453,4.343805421853684
6809,5,59,No,8,5,295,64,472,295,40,67,0.08333333333333333,0.13333333333333333,1.791759469228055,4.0943445622221
4705,4,72,Yes,9,5,288,76,648,360,36,81,0.0547945205479452,0.1232876712328767,1.6094379124341003,4.290459441148391
3870,8,98,Yes,7,0,784,106,686,0,56,105,0.08080808080808081,0.0707070707070707,2.1972245773362196,4.59511985013459
1656,9,94,Yes,4,8,846,103,376,752,36,98,0.09473684210526316,0.042105263157894736,2.302585092994046,4.553876891600541
3188,9,76,Yes,7,1,684,85,532,76,63,83,0.11688311688311688,0.09090909090909091,2.302585092994046,4.343805421853684
684,6,55,Yes,6,6,330,61,330,330,36,61,0.10714285714285714,0.10714285714285714,1.9459101490553132,4.02535169073515
4171,8,71,No,6,3,568,79,426,213,48,77,0.1111111111111111,0.08333333333333333,2.1972245773362196,4.276666119016055
4478,5,53,Yes,8,8,265,58,424,424,40,61,0.09259259259259259,0.14814814814814814,1.791759469228055,3.9889840465642745
462,5,59,No,5,1,295,64,295,59,25,64,0.08333333333333333,0.08333333333333333,1.791759469228055,4.0943445622221
5765,2,44,Yes,7,4,88,46,308,176,14,51,0.044444444444444446,0.15555555555555556,1.0986122886681098,3.8066624897703196
7523,3,85,Yes,9,0,255,88,765,0,27,94,0.03488372093023256,0.10465116279069768,1.3862943611198906,4.454347296253507
4503,3,92,No,5,4,276,95,460,368,15,97,0.03225806451612903,0.053763440860215055,1.3862943611198906,4.532599493153256
9710,2,40,No,9,8,80,42,360,320,18,49,0.04878048780487805,0.21951219512195122,1.0986122886681098,3.713572066704308
319,7,95,No,8,9,665,102,760,855,56,103,0.07291666666666667,0.08333333333333333,2.0794415416798357,4.564348191467836
1146,9,78,Yes,4,3,702,87,312,234,36,82,0.11392405063291139,0.05063291139240506,2.302585092994046,4.3694478524670215
5095,8,95,No,7,6,760,103,665,570,56,102,0.08333333333333333,0.07291666666666667,2.1972245773362196,4.564348191467836
1394,1,72,Yes,6,2,72,73,432,144,6,78,0.0136986301369863,0.0821917808219178,0.6931471805599453,4.290459441148391
6624,2,89,No,9,6,178,91,801,534,18,98,0.022222222222222223,0.1,1.0986122886681098,4.499809670330265
1502,6,44,No,8,0,264,50,352,0,48,52,0.13333333333333333,0.17777777777777778,1.9459101490553132,3.8066624897703196
6409,1,78,No,9,0,78,79,702,0,9,87,0.012658227848101266,0.11392405063291139,0.6931471805599453,4.3694478524670215
377,5,56,Yes,4,7,280,61,224,392,20,60,0.08771929824561403,0.07017543859649122,1.791759469228055,4.04305126783455
411,2,76,No,9,6,152,78,684,456,18,85,0.025974025974025976,0.11688311688311688,1.0986122886681098,4.343805421853684
1661,5,89,No,4,6,445,94,356,534,20,93,0.05555555555555555,0.044444444444444446,1.791759469228055,4.499809670330265
3152,8,48,No,9,6,384,56,432,288,72,57,0.16326530612244897,0.1836734693877551,2.1972245773362196,3.8918202981106265
1624,7,96,Yes,7,2,672,103,672,192,49,103,0.07216494845360824,0.07216494845360824,2.0794415416798357,4.574710978503383
5610,4,51,Yes,4,0,204,55,204,0,16,55,0.07692307692307693,0.07692307692307693,1.6094379124341003,3.9512437185814275
8533,2,52,No,8,4,104,54,416,208,16,60,0.03773584905660377,0.1509433962264151,1.0986122886681098,3.970291913552122
5803,3,40,Yes,8,4,120,43,320,160,24,48,0.07317073170731707,0.1951219512195122,1.3862943611198906,3.713572066704308
5307,5,56,Yes,8,8,280,61,448,448,40,64,0.08771929824561403,0.14035087719298245,1.791759469228055,4.04305126783455
7087,8,47,No,7,7,376,55,329,329,56,54,0.16666666666666666,0.14583333333333334,2.1972245773362196,3.871201010907891
8898,9,81,Yes,7,3,729,90,567,243,63,88,0.10975609756097561,0.08536585365853659,2.302585092994046,4.406719247264253
7489,9,87,Yes,6,5,783,96,522,435,54,93,0.10227272727272728,0.06818181818181818,2.302585092994046,4.477336814478207
9616,6,77,Yes,6,9,462,83,462,693,36,83,0.07692307692307693,0.07692307692307693,1.9459101490553132,4.356708826689592
9218,8,56,Yes,6,3,448,64,336,168,48,62,0.14035087719298245,0.10526315789473684,2.1972245773362196,4.04305126783455
1673,7,62,No,7,6,434,69,434,372,49,69,0.1111111111111111,0.1111111111111111,2.0794415416798357,4.143134726391533
2359,4,77,Yes,7,9,308,81,539,693,28,84,0.05128205128205128,0.08974358974358974,1.6094379124341003,4.356708826689592
8468,3,79,No,8,1,237,82,632,79,24,87,0.0375,0.1,1.3862943611198906,4.382026634673881
275,5,51,Yes,5,7,255,56,255,357,25,56,0.09615384615384616,0.09615384615384616,1.791759469228055,3.9512437185814275
2474,7,64,No,4,3,448,71,256,192,28,68,0.1076923076923077,0.06153846153846154,2.0794415416798357,4.174387269895637
5490,5,56,No,5,8,280,61,280,448,25,61,0.08771929824561403,0.08771929824561403,1.791759469228055,4.04305126783455
4772,1,67,Yes,4,6,67,68,268,402,4,71,0.014705882352941176,0.058823529411764705,0.6931471805599453,4.219507705176107
2108,7,47,No,5,0,329,54,235,0,35,52,0.14583333333333334,0.10416666666666667,2.0794415416798357,3.871201010907891
7501,4,54,Yes,6,8,216,58,324,432,24,60,0.07272727272727272,0.10909090909090909,1.6094379124341003,4.007333185232471
4415,2,86,No,7,2,172,88,602,172,14,93,0.022988505747126436,0.08045977011494253,1.0986122886681098,4.465908118654584
8139,6,96,No,6,3,576,102,576,288,36,102,0.061855670103092786,0.061855670103092786,1.9459101490553132,4.574710978503383
8661,4,45,No,7,1,180,49,315,45,28,52,0.08695652173913043,0.15217391304347827,1.6094379124341003,3.828641396489095
8240,5,84,Yes,4,2,420,89,336,168,20,88,0.058823529411764705,0.047058823529411764,1.791759469228055,4.442651256490317
2418,7,60,No,7,8,420,67,420,480,49,67,0.11475409836065574,0.11475409836065574,2.0794415416798357,4.110873864173311
8772,4,43,No,9,2,172,47,387,86,36,52,0.09090909090909091,0.20454545454545456,1.6094379124341003,3.784189633918261
2237,3,96,Yes,7,1,288,99,672,96,21,103,0.030927835051546393,0.07216494845360824,1.3862943611198906,4.574710978503383
3768,8,70,Yes,7,5,560,78,490,350,56,77,0.11267605633802817,0.09859154929577464,2.1972245773362196,4.2626798770413155
9792,8,45,Yes,4,0,360,53,180,0,32,49,0.17391304347826086,0.08695652173913043,2.1972245773362196,3.828641396489095
9990,3,46,No,5,8,138,49,230,368,15,51,0.06382978723404255,0.10638297872340426,1.3862943611198906,3.8501476017100584
9966,8,76,Yes,8,6,608,84,608,456,64,84,0.1038961038961039,0.1038961038961039,2.1972245773362196,4.343805421853684
7324,4,83,No,5,3,332,87,415,249,20,88,0.047619047619047616,0.05952380952380952,1.6094379124341003,4.430816798843313
1384,4,42,No,5,4,168,46,210,168,20,47,0.09302325581395349,0.11627906976744186,1.6094379124341003,3.7612001156935624
3102,5,61,Yes,5,8,305,66,305,488,25,66,0.08064516129032258,0.08064516129032258,1.791759469228055,4.127134385045092
3922,2,54,No,7,0,108,56,378,0,14,61,0.03636363636363636,0.12727272727272726,1.0986122886681098,4.007333185232471
6686,2,41,Yes,6,6,82,43,246,246,12,47,0.047619047619047616,0.14285714285714285,1.0986122886681098,3.7376696182833684
3195,2,67,Yes,5,7,134,69,335,469,10,72,0.029411764705882353,0.07352941176470588,1.0986122886681098,4.219507705176107
1942,5,62,Yes,9,4,310,67,558,248,45,71,0.07936507936507936,0.14285714285714285,1.791759469228055,4.143134726391533
7714,5,78,Yes,4,1,390,83,312,78,20,82,0.06329113924050633,0.05063291139240506,1.791759469228055,4.3694478524670215
4897,1,54,Yes,8,5,54,55,432,270,8,62,0.01818181818181818,0.14545454545454545,0.6931471805599453,4.007333185232471
4783,1,87,Yes,7,5,87,88,609,435,7,94,0.011363636363636364,0.07954545454545454,0.6931471805599453,4.477336814478207
1497,3,84,No,6,6,252,87,504,504,18,90,0.03529411764705882,0.07058823529411765,1.3862943611198906,4.442651256490317
1958,1,92,Yes,4,6,92,93,368,552,4,96,0.010752688172043012,0.043010752688172046,0.6931471805599453,4.532599493153256
9172,4,81,Yes,7,0,324,85,567,0,28,88,0.04878048780487805,0.08536585365853659,1.6094379124341003,4.406719247264253
9746,7,93,No,6,2,651,100,558,186,42,99,0.07446808510638298,0.06382978723404255,2.0794415416798357,4.543294782270004
7333,8,62,No,5,1,496,70,310,62,40,67,0.12698412698412698,0.07936507936507936,2.1972245773362196,4.143134726391533
7950,2,90,Yes,6,9,180,92,540,810,12,96,0.02197802197802198,0.06593406593406594,1.0986122886681098,4.51085950651685
3018,9,43,Yes,9,1,387,52,387,43,81,52,0.20454545454545456,0.20454545454545456,2.302585092994046,3.784189633918261
6747,2,86,Yes,8,3,172,88,688,258,16,94,0.022988505747126436,0.09195402298850575,1.0986122886681098,4.465908118654584
514,9,87,No,8,9,783,96,696,783,72,95,0.10227272727272728,0.09090909090909091,2.302585092994046,4.477336814478207
3935,7,89,No,5,5,623,96,445,445,35,94,0.07777777777777778,0.05555555555555555,2.0794415416798357,4.499809670330265
3026,5,66,No,6,8,330,71,396,528,30,72,0.07462686567164178,0.08955223880597014,1.791759469228055,4.204692619390966
1200,7,65,Yes,9,6,455,72,585,390,63,74,0.10606060606060606,0.13636363636363635,2.0794415416798357,4.189654742026425
5029,5,69,No,6,0,345,74,414,0,30,75,0.07142857142857142,0.08571428571428572,1.791759469228055,4.248495242049359
9785,1,69,No,8,8,69,70,552,552,8,77,0.014285714285714285,0.11428571428571428,0.6931471805599453,4.248495242049359
922,5,45,Yes,6,0,225,50,270,0,30,51,0.10869565217391304,0.13043478260869565,1.791759469228055,3.828641396489095
4650,3,42,Yes,6,8,126,45,252,336,18,48,0.06976744186046512,0.13953488372093023,1.3862943611198906,3.7612001156935624
5333,4,41,Yes,8,7,164,45,328,287,32,49,0.09523809523809523,0.19047619047619047,1.6094379124341003,3.7376696182833684
1077,5,76,Yes,6,5,380,81,456,380,30,82,0.06493506493506493,0.07792207792207792,1.791759469228055,4.343805421853684
6769,1,49,No,6,8,49,50,294,392,6,55,0.02,0.12,0.6931471805599453,3.912023005428146
9411,3,82,Yes,5,1,246,85,410,82,15,87,0.03614457831325301,0.060240963855421686,1.3862943611198906,4.418840607796598
1672,9,76,No,7,2,684,85,532,152,63,83,0.11688311688311688,0.09090909090909091,2.302585092994046,4.343805421853684
475,5,70,No,7,4,350,75,490,280,35,77,0.07042253521126761,0.09859154929577464,1.791759469228055,4.2626798770413155
9187,4,43,Yes,6,9,172,47,258,387,24,49,0.09090909090909091,0.13636363636363635,1.6094379124341003,3.784189633918261
8840,5,86,Yes,6,3,430,91,516,258,30,92,0.05747126436781609,0.06896551724137931,1.791759469228055,4.465908118654584
5759,4,44,Yes,9,9,176,48,396,396,36,53,0.08888888888888889,0.2,1.6094379124341003,3.8066624897703196
6298,2,46,No,9,2,92,48,414,92,18,55,0.0425531914893617,0.19148936170212766,1.0986122886681098,3.8501476017100584
2479,8,68,Yes,5,1,544,76,340,68,40,73,0.11594202898550725,0.07246376811594203,2.1972245773362196,4.23410650459726
5494,3,96,No,5,5,288,99,480,480,15,101,0.030927835051546393,0.05154639175257732,1.3862943611198906,4.574710978503383
3915,1,96,No,9,5,96,97,864,480,9,105,0.010309278350515464,0.09278350515463918,0.6931471805599453,4.574710978503383
2139,7,89,Yes,4,0,623,96,356,0,28,93,0.07777777777777778,0.044444444444444446,2.0794415416798357,4.499809670330265
5455,1,94,Yes,6,3,94,95,564,282,6,100,0.010526315789473684,0.06315789473684211,0.6931471805599453,4.553876891600541
5380,8,83,No,7,8,664,91,581,664,56,90,0.09523809523809523,0.08333333333333333,2.1972245773362196,4.430816798843313
8986,5,85,No,8,9,425,90,680,765,40,93,0.05813953488372093,0.09302325581395349,1.791759469228055,4.454347296253507
4024,8,56,Yes,5,7,448,64,280,392,40,61,0.14035087719298245,0.08771929824561403,2.1972245773362196,4.04305126783455
3486,1,76,No,5,8,76,77,380,608,5,81,0.012987012987012988,0.06493506493506493,0.6931471805599453,4.343805421853684
2456,4,83,Yes,6,3,332,87,498,249,24,89,0.047619047619047616,0.07142857142857142,1.6094379124341003,4.430816798843313
2465,5,74,Yes,7,1,370,79,518,74,35,81,0.06666666666666667,0.09333333333333334,1.791759469228055,4.31748811353631
8697,7,67,Yes,9,6,469,74,603,402,63,76,0.10294117647058823,0.1323529411764706,2.0794415416798357,4.219507705176107
1370,1,86,No,5,4,86,87,430,344,5,91,0.011494252873563218,0.05747126436781609,0.6931471805599453,4.465908118654584
6689,5,96,No,6,2,480,101,576,192,30,102,0.05154639175257732,0.061855670103092786,1.791759469228055,4.574710978503383
7457,6,89,No,7,7,534,95,623,623,42,96,0.06666666666666667,0.07777777777777778,1.9459101490553132,4.499809670330265
9975,2,98,No,7,9,196,100,686,882,14,105,0.020202020202020204,0.0707070707070707,1.0986122886681098,4.59511985013459
1902,7,84,No,7,0,588,91,588,0,49,91,0.08235294117647059,0.08235294117647059,2.0794415416798357,4.442651256490317
4872,6,99,Yes,5,6,594,105,495,594,30,104,0.06,0.05,1.9459101490553132,4.605170185988092
4711,3,99,Yes,6,8,297,102,594,792,18,105,0.03,0.06,1.3862943611198906,4.605170185988092
7887,3,63,No,7,9,189,66,441,567,21,70,0.046875,0.109375,1.3862943611198906,4.1588830833596715
1794,7,41,Yes,6,8,287,48,246,328,42,47,0.16666666666666666,0.14285714285714285,2.0794415416798357,3.7376696182833684
2875,3,64,Yes,6,0,192,67,384,0,18,70,0.046153846153846156,0.09230769230769231,1.3862943611198906,4.174387269895637
6218,7,68,Yes,7,5,476,75,476,340,49,75,0.10144927536231885,0.10144927536231885,2.0794415416798357,4.23410650459726
5214,6,68,Yes,7,2,408,74,476,136,42,75,0.08695652173913043,0.10144927536231885,1.9459101490553132,4.23410650459726
2246,3,60,Yes,8,2,180,63,480,120,24,68,0.04918032786885246,0.13114754098360656,1.3862943611198906,4.110873864173311
1742,7,65,Yes,7,0,455,72,455,0,49,72,0.10606060606060606,0.10606060606060606,2.0794415416798357,4.189654742026425
1021,2,76,Yes,4,7,152,78,304,532,8,80,0.025974025974025976,0.05194805194805195,1.0986122886681098,4.343805421853684
706,3,65,Yes,4,0,195,68,260,0,12,69,0.045454545454545456,0.06060606060606061,1.3862943611198906,4.189654742026425
4295,5,85,No,6,1,425,90,510,85,30,91,0.05813953488372093,0.06976744186046512,1.791759469228055,4.454347296253507
5577,6,81,No,7,2,486,87,567,162,42,88,0.07317073170731707,0.08536585365853659,1.9459101490553132,4.406719247264253
7167,7,81,No,4,5,567,88,324,405,28,85,0.08536585365853659,0.04878048780487805,2.0794415416798357,4.406719247264253
8178,1,59,Yes,7,4,59,60,413,236,7,66,0.016666666666666666,0.11666666666666667,0.6931471805599453,4.0943445622221
909,7,88,Yes,6,8,616,95,528,704,42,94,0.07865168539325842,0.06741573033707865,2.0794415416798357,4.48863636973214
5194,1,64,No,8,7,64,65,512,448,8,72,0.015384615384615385,0.12307692307692308,0.6931471805599453,4.174387269895637
3078,4,94,Yes,8,2,376,98,752,188,32,102,0.042105263157894736,0.08421052631578947,1.6094379124341003,4.553876891600541
9367,1,91,Yes,9,5,91,92,819,455,9,100,0.010869565217391304,0.09782608695652174,0.6931471805599453,4.5217885770490405
595,5,70,No,8,0,350,75,560,0,40,78,0.07042253521126761,0.11267605633802817,1.791759469228055,4.2626798770413155
5305,7,40,No,8,2,280,47,320,80,56,48,0.17073170731707318,0.1951219512195122,2.0794415416798357,3.713572066704308
441,5,56,Yes,8,9,280,61,448,504,40,64,0.08771929824561403,0.14035087719298245,1.791759469228055,4.04305126783455
7607,9,45,Yes,7,4,405,54,315,180,63,52,0.1956521739130435,0.15217391304347827,2.302585092994046,3.828641396489095
4093,7,47,Yes,5,7,329,54,235,329,35,52,0.14583333333333334,0.10416666666666667,2.0794415416798357,3.871201010907891
6135,3,91,Yes,9,8,273,94,819,728,27,100,0.03260869565217391,0.09782608695652174,1.3862943611198906,4.5217885770490405
11,8,91,No,4,5,728,99,364,455,32,95,0.08695652173913043,0.043478260869565216,2.1972245773362196,4.5217885770490405
3777,2,81,No,9,2,162,83,729,162,18,90,0.024390243902439025,0.10975609756097561,1.0986122886681098,4.406719247264253
9000,2,66,No,6,9,132,68,396,594,12,72,0.029850746268656716,0.08955223880597014,1.0986122886681098,4.204692619390966
3709,8,69,Yes,4,8,552,77,276,552,32,73,0.11428571428571428,0.05714285714285714,2.1972245773362196,4.248495242049359
3781,3,90,Yes,6,2,270,93,540,180,18,96,0.03296703296703297,0.06593406593406594,1.3862943611198906,4.51085950651685
94,8,84,Yes,5,0,672,92,420,0,40,89,0.09411764705882353,0.058823529411764705,2.1972245773362196,4.442651256490317
9240,6,58,Yes,4,5,348,64,232,290,24,62,0.1016949152542373,0.06779661016949153,1.9459101490553132,4.07753744390572
3950,4,62,No,6,7,248,66,372,434,24,68,0.06349206349206349,0.09523809523809523,1.6094379124341003,4.143134726391533
5786,6,44,No,5,1,264,50,220,44,30,49,0.13333333333333333,0.1111111111111111,1.9459101490553132,3.8066624897703196
4871,5,85,Yes,5,8,425,90,425,680,25,90,0.05813953488372093,0.05813953488372093,1.791759469228055,4.454347296253507
4803,1,56,Yes,8,5,56,57,448,280,8,64,0.017543859649122806,0.14035087719298245,0.6931471805599453,4.04305126783455
4868,2,90,Yes,7,6,180,92,630,540,14,97,0.02197802197802198,0.07692307692307693,1.0986122886681098,4.51085950651685
293,3,52,Yes,5,7,156,55,260,364,15,57,0.05660377358490566,0.09433962264150944,1.3862943611198906,3.970291913552122
7889,8,51,No,7,8,408,59,357,408,56,58,0.15384615384615385,0.1346153846153846,2.1972245773362196,3.9512437185814275
7406,7,66,No,9,8,462,73,594,528,63,75,0.1044776119402985,0.13432835820895522,2.0794415416798357,4.204692619390966
5596,1,46,No,8,1,46,47,368,46,8,54,0.02127659574468085,0.1702127659574468,0.6931471805599453,3.8501476017100584
2887,8,78,Yes,6,1,624,86,468,78,48,84,0.10126582278481013,0.0759493670886076,2.1972245773362196,4.3694478524670215
6455,5,80,No,6,6,400,85,480,480,30,86,0.06172839506172839,0.07407407407407407,1.791759469228055,4.394449154672439
2543,3,67,Yes,9,0,201,70,603,0,27,76,0.04411764705882353,0.1323529411764706,1.3862943611198906,4.219507705176107
1766,2,80,Yes,4,3,160,82,320,240,8,84,0.024691358024691357,0.04938271604938271,1.0986122886681098,4.394449154672439
6801,9,70,No,8,8,630,79,560,560,72,78,0.1267605633802817,0.11267605633802817,2.302585092994046,4.2626798770413155
1878,5,97,Yes,9,9,485,102,873,873,45,106,0.05102040816326531,0.09183673469387756,1.791759469228055,4.584967478670572
1982,2,70,No,6,0,140,72,420,0,12,76,0.028169014084507043,0.08450704225352113,1.0986122886681098,4.2626798770413155
9730,7,82,No,7,4,574,89,574,328,49,89,0.08433734939759036,0.08433734939759036,2.0794415416798357,4.418840607796598
9609,7,93,No,8,7,651,100,744,651,56,101,0.07446808510638298,0.0851063829787234,2.0794415416798357,4.543294782270004
2686,9,41,Yes,8,6,369,50,328,246,72,49,0.21428571428571427,0.19047619047619047,2.302585092994046,3.7376696182833684
8931,6,73,Yes,8,1,438,79,584,73,48,81,0.08108108108108109,0.10810810810810811,1.9459101490553132,4.30406509320417
3459,5,92,No,5,9,460,97,460,828,25,97,0.053763440860215055,0.053763440860215055,1.791759469228055,4.532599493153256
4542,2,55,Yes,6,3,110,57,330,165,12,61,0.03571428571428571,0.10714285714285714,1.0986122886681098,4.02535169073515
2179,3,63,No,6,1,189,66,378,63,18,69,0.046875,0.09375,1.3862943611198906,4.1588830833596715
4451,7,90,Yes,7,2,630,97,630,180,49,97,0.07692307692307693,0.07692307692307693,2.0794415416798357,4.51085950651685
3860,6,82,Yes,9,8,492,88,738,656,54,91,0.07228915662650602,0.10843373493975904,1.9459101490553132,4.418840607796598
7624,6,64,No,9,9,384,70,576,576,54,73,0.09230769230769231,0.13846153846153847,1.9459101490553132,4.174387269895637
7655,2,78,Yes,8,8,156,80,624,624,16,86,0.02531645569620253,0.10126582278481013,1.0986122886681098,4.3694478524670215
4520,4,56,No,9,3,224,60,504,168,36,65,0.07017543859649122,0.15789473684210525,1.6094379124341003,4.04305126783455
2518,9,46,No,4,5,414,55,184,230,36,50,0.19148936170212766,0.0851063829787234,2.302585092994046,3.8501476017100584
4837,7,72,No,9,6,504,79,648,432,63,81,0.0958904109589041,0.1232876712328767,2.0794415416798357,4.290459441148391
2886,2,84,No,4,9,168,86,336,756,8,88,0.023529411764705882,0.047058823529411764,1.0986122886681098,4.442651256490317
7282,4,97,No,9,5,388,101,873,485,36,106,0.04081632653061224,0.09183673469387756,1.6094379124341003,4.584967478670572
6256,7,87,No,5,8,609,94,435,696,35,92,0.07954545454545454,0.056818181818181816,2.0794415416798357,4.477336814478207
4540,4,98,No,4,3,392,102,392,294,16,102,0.04040404040404041,0.04040404040404041,1.6094379124341003,4.59511985013459
5640,9,69,Yes,6,8,621,78,414,552,54,75,0.12857142857142856,0.08571428571428572,2.302585092994046,4.248495242049359
9460,4,64,Yes,8,9,256,68,512,576,32,72,0.06153846153846154,0.12307692307692308,1.6094379124341003,4.174387269895637
3482,2,96,Yes,9,8,192,98,864,768,18,105,0.020618556701030927,0.09278350515463918,1.0986122886681098,4.574710978503383
1278,2,97,No,8,1,194,99,776,97,16,105,0.02040816326530612,0.08163265306122448,1.0986122886681098,4.584967478670572
3147,4,90,Yes,9,6,360,94,810,540,36,99,0.04395604395604396,0.0989010989010989,1.6094379124341003,4.51085950651685
8263,9,54,No,5,3,486,63,270,162,45,59,0.16363636363636364,0.09090909090909091,2.302585092994046,4.007333185232471
3206,8,63,Yes,4,3,504,71,252,189,32,67,0.125,0.0625,2.1972245773362196,4.1588830833596715
9893,8,75,Yes,8,3,600,83,600,225,64,83,0.10526315789473684,0.10526315789473684,2.1972245773362196,4.330733340286331
2743,2,90,No,4,4,180,92,360,360,8,94,0.02197802197802198,0.04395604395604396,1.0986122886681098,4.51085950651685
6077,6,54,No,7,2,324,60,378,108,42,61,0.10909090909090909,0.12727272727272726,1.9459101490553132,4.007333185232471
4048,3,73,No,6,7,219,76,438,511,18,79,0.04054054054054054,0.08108108108108109,1.3862943611198906,4.30406509320417
5732,2,64,No,6,3,128,66,384,192,12,70,0.03076923076923077,0.09230769230769231,1.0986122886681098,4.174387269895637
2946,3,44,No,7,5,132,47,308,220,21,51,0.06666666666666667,0.15555555555555556,1.3862943611198906,3.8066624897703196
5791,7,79,Yes,7,5,553,86,553,395,49,86,0.0875,0.0875,2.0794415416798357,4.382026634673881
6795,4,52,No,4,2,208,56,208,104,16,56,0.07547169811320754,0.07547169811320754,1.6094379124341003,3.970291913552122
6544,9,91,No,7,0,819,100,637,0,63,98,0.09782608695652174,0.07608695652173914,2.302585092994046,4.5217885770490405
701,3,66,No,4,6,198,69,264,396,12,70,0.04477611940298507,0.05970149253731343,1.3862943611198906,4.204692619390966
3575,7,73,No,7,5,511,80,511,365,49,80,0.0945945945945946,0.0945945945945946,2.0794415416798357,4.30406509320417
7700,6,50,No,5,8,300,56,250,400,30,55,0.11764705882352941,0.09803921568627451,1.9459101490553132,3.9318256327243257
2516,7,75,Yes,4,5,525,82,300,375,28,79,0.09210526315789473,0.05263157894736842,2.0794415416798357,4.330733340286331
3001,8,78,No,6,4,624,86,468,312,48,84,0.10126582278481013,0.0759493670886076,2.1972245773362196,4.3694478524670215
5821,1,57,No,7,6,57,58,399,342,7,64,0.017241379310344827,0.1206896551724138,0.6931471805599453,4.060443010546419
8582,9,60,Yes,6,1,540,69,360,60,54,66,0.14754098360655737,0.09836065573770492,2.302585092994046,4.110873864173311
3685,4,45,Yes,4,8,180,49,180,360,16,49,0.08695652173913043,0.08695652173913043,1.6094379124341003,3.828641396489095
2996,2,65,Yes,8,1,130,67,520,65,16,73,0.030303030303030304,0.12121212121212122,1.0986122886681098,4.189654742026425
4253,4,92,Yes,9,5,368,96,828,460,36,101,0.043010752688172046,0.0967741935483871,1.6094379124341003,4.532599493153256
3412,4,99,No,6,4,396,103,594,396,24,105,0.04,0.06,1.6094379124341003,4.605170185988092
7963,7,57,No,6,9,399,64,342,513,42,63,0.1206896551724138,0.10344827586206896,2.0794415416798357,4.060443010546419
6310,5,91,Yes,6,3,455,96,546,273,30,97,0.05434782608695652,0.06521739130434782,1.791759469228055,4.5217885770490405
8612,2,69,No,9,0,138,71,621,0,18,78,0.02857142857142857,0.12857142857142856,1.0986122886681098,4.248495242049359
5013,7,63,No,7,5,441,70,441,315,49,70,0.109375,0.109375,2.0794415416798357,4.1588830833596715
7751,9,58,Yes,4,3,522,67,232,174,36,62,0.15254237288135594,0.06779661016949153,2.302585092994046,4.07753744390572
5980,6,54,No,9,7,324,60,486,378,54,63,0.10909090909090909,0.16363636363636364,1.9459101490553132,4.007333185232471
4049,8,53,No,8,4,424,61,424,212,64,61,0.14814814814814814,0.14814814814814814,2.1972245773362196,3.9889840465642745
4900,5,56,Yes,9,8,280,61,504,448,45,65,0.08771929824561403,0.15789473684210525,1.791759469228055,4.04305126783455
1319,7,79,No,9,0,553,86,711,0,63,88,0.0875,0.1125,2.0794415416798357,4.382026634673881
9773,3,61,No,6,1,183,64,366,61,18,67,0.04838709677419355,0.0967741935483871,1.3862943611198906,4.127134385045092
9138,9,83,No,9,8,747,92,747,664,81,92,0.10714285714285714,0.10714285714285714,2.302585092994046,4.430816798843313
7143,1,62,No,9,5,62,63,558,310,9,71,0.015873015873015872,0.14285714285714285,0.6931471805599453,4.143134726391533
1898,3,54,No,9,7,162,57,486,378,27,63,0.05454545454545454,0.16363636363636364,1.3862943611198906,4.007333185232471
7466,6,54,No,7,1,324,60,378,54,42,61,0.10909090909090909,0.12727272727272726,1.9459101490553132,4.007333185232471
604,1,99,Yes,9,8,99,100,891,792,9,108,0.01,0.09,0.6931471805599453,4.605170185988092
2847,7,64,Yes,7,8,448,71,448,512,49,71,0.1076923076923077,0.1076923076923077,2.0794415416798357,4.174387269895637
8208,1,49,Yes,8,3,49,50,392,147,8,57,0.02,0.16,0.6931471805599453,3.912023005428146
394,7,66,No,6,7,462,73,396,462,42,72,0.1044776119402985,0.08955223880597014,2.0794415416798357,4.204692619390966
4437,6,59,Yes,7,4,354,65,413,236,42,66,0.1,0.11666666666666667,1.9459101490553132,4.0943445622221
9448,1,80,No,5,4,80,81,400,320,5,85,0.012345679012345678,0.06172839506172839,0.6931471805599453,4.394449154672439
7235,6,95,Yes,8,9,570,101,760,855,48,103,0.0625,0.08333333333333333,1.9459101490553132,4.564348191467836
5399,1,98,Yes,8,2,98,99,784,196,8,106,0.010101010101010102,0.08080808080808081,0.6931471805599453,4.59511985013459
96,3,48,No,7,5,144,51,336,240,21,55,0.061224489795918366,0.14285714285714285,1.3862943611198906,3.8918202981106265
1663,4,96,No,8,2,384,100,768,192,32,104,0.041237113402061855,0.08247422680412371,1.6094379124341003,4.574710978503383
8971,1,50,Yes,4,1,50,51,200,50,4,54,0.0196078431372549,0.0784313725490196,0.6931471805599453,3.9318256327243257
5131,5,55,Yes,8,0,275,60,440,0,40,63,0.08928571428571429,0.14285714285714285,1.791759469228055,4.02535169073515
1489,3,90,Yes,7,1,270,93,630,90,21,97,0.03296703296703297,0.07692307692307693,1.3862943611198906,4.51085950651685
8317,8,57,No,5,2,456,65,285,114,40,62,0.13793103448275862,0.08620689655172414,2.1972245773362196,4.060443010546419
2708,8,69,No,8,2,552,77,552,138,64,77,0.11428571428571428,0.11428571428571428,2.1972245773362196,4.248495242049359
1596,4,57,Yes,9,4,228,61,513,228,36,66,0.06896551724137931,0.15517241379310345,1.6094379124341003,4.060443010546419
9278,4,79,No,5,6,316,83,395,474,20,84,0.05,0.0625,1.6094379124341003,4.382026634673881
2378,7,64,No,4,5,448,71,256,320,28,68,0.1076923076923077,0.06153846153846154,2.0794415416798357,4.174387269895637
5141,2,66,Yes,5,6,132,68,330,396,10,71,0.029850746268656716,0.07462686567164178,1.0986122886681098,4.204692619390966
6148,9,43,No,8,9,387,52,344,387,72,51,0.20454545454545456,0.18181818181818182,2.302585092994046,3.784189633918261
8242,4,87,No,8,5,348,91,696,435,32,95,0.045454545454545456,0.09090909090909091,1.6094379124341003,4.477336814478207
3949,6,89,Yes,5,2,534,95,445,178,30,94,0.06666666666666667,0.05555555555555555,1.9459101490553132,4.499809670330265
3934,1,61,No,8,6,61,62,488,366,8,69,0.016129032258064516,0.12903225806451613,0.6931471805599453,4.127134385045092
4798,9,46,Yes,7,8,414,55,322,368,63,53,0.19148936170212766,0.14893617021276595,2.302585092994046,3.8501476017100584
4373,8,85,Yes,6,1,680,93,510,85,48,91,0.09302325581395349,0.06976744186046512,2.1972245773362196,4.454347296253507
9863,4,92,No,8,5,368,96,736,460,32,100,0.043010752688172046,0.08602150537634409,1.6094379124341003,4.532599493153256
8243,4,87,No,8,4,348,91,696,348,32,95,0.045454545454545456,0.09090909090909091,1.6094379124341003,4.477336814478207
3449,8,91,Yes,6,7,728,99,546,637,48,97,0.08695652173913043,0.06521739130434782,2.1972245773362196,4.5217885770490405
2944,3,94,Yes,5,1,282,97,470,94,15,99,0.031578947368421054,0.05263157894736842,1.3862943611198906,4.553876891600541
2466,3,45,No,6,7,135,48,270,315,18,51,0.06521739130434782,0.13043478260869565,1.3862943611198906,3.828641396489095
8583,9,54,No,5,8,486,63,270,432,45,59,0.16363636363636364,0.09090909090909091,2.302585092994046,4.007333185232471
5507,9,86,Yes,6,4,774,95,516,344,54,92,0.10344827586206896,0.06896551724137931,2.302585092994046,4.465908118654584
2699,9,44,No,4,0,396,53,176,0,36,48,0.2,0.08888888888888889,2.302585092994046,3.8066624897703196
2448,2,68,Yes,8,9,136,70,544,612,16,76,0.028985507246376812,0.11594202898550725,1.0986122886681098,4.23410650459726
20,5,75,No,7,0,375,80,525,0,35,82,0.06578947368421052,0.09210526315789473,1.791759469228055,4.330733340286331
2749,8,87,No,8,2,696,95,696,174,64,95,0.09090909090909091,0.09090909090909091,2.1972245773362196,4.477336814478207
5400,2,42,No,7,8,84,44,294,336,14,49,0.046511627906976744,0.16279069767441862,1.0986122886681098,3.7612001156935624
8079,9,81,Yes,6,2,729,90,486,162,54,87,0.10975609756097561,0.07317073170731707,2.302585092994046,4.406719247264253
6872,9,95,No,6,0,855,104,570,0,54,101,0.09375,0.0625,2.302585092994046,4.564348191467836
4709,1,68,Yes,4,4,68,69,272,272,4,72,0.014492753623188406,0.057971014492753624,0.6931471805599453,4.23410650459726
9477,1,74,No,7,1,74,75,518,74,7,81,0.013333333333333334,0.09333333333333334,0.6931471805599453,4.31748811353631
810,2,66,No,8,6,132,68,528,396,16,74,0.029850746268656716,0.11940298507462686,1.0986122886681098,4.204692619390966
7478,3,81,Yes,9,1,243,84,729,81,27,90,0.036585365853658534,0.10975609756097561,1.3862943611198906,4.406719247264253
2274,6,83,No,4,3,498,89,332,249,24,87,0.07142857142857142,0.047619047619047616,1.9459101490553132,4.430816798843313
1924,9,67,Yes,7,1,603,76,469,67,63,74,0.1323529411764706,0.10294117647058823,2.302585092994046,4.219507705176107
1471,7,51,No,8,2,357,58,408,102,56,59,0.1346153846153846,0.15384615384615385,2.0794415416798357,3.9512437185814275
7935,1,89,No,5,6,89,90,445,534,5,94,0.011111111111111112,0.05555555555555555,0.6931471805599453,4.499809670330265
7408,5,66,Yes,5,4,330,71,330,264,25,71,0.07462686567164178,0.07462686567164178,1.791759469228055,4.204692619390966
2407,1,81,No,9,7,81,82,729,567,9,90,0.012195121951219513,0.10975609756097561,0.6931471805599453,4.406719247264253
1143,5,48,No,5,5,240,53,240,240,25,53,0.10204081632653061,0.10204081632653061,1.791759469228055,3.8918202981106265
1748,6,54,Yes,6,9,324,60,324,486,36,60,0.10909090909090909,0.10909090909090909,1.9459101490553132,4.007333185232471
5710,2,44,No,7,9,88,46,308,396,14,51,0.044444444444444446,0.15555555555555556,1.0986122886681098,3.8066624897703196
4976,2,86,Yes,6,2,172,88,516,172,12,92,0.022988505747126436,0.06896551724137931,1.0986122886681098,4.465908118654584
7301,6,56,No,6,7,336,62,336,392,36,62,0.10526315789473684,0.10526315789473684,1.9459101490553132,4.04305126783455
8149,6,51,Yes,4,7,306,57,204,357,24,55,0.11538461538461539,0.07692307692307693,1.9459101490553132,3.9512437185814275
2834,4,68,Yes,5,5,272,72,340,340,20,73,0.057971014492753624,0.07246376811594203,1.6094379124341003,4.23410650459726
3132,7,91,No,4,3,637,98,364,273,28,95,0.07608695652173914,0.043478260869565216,2.0794415416798357,4.5217885770490405
1311,3,58,No,4,1,174,61,232,58,12,62,0.05084745762711865,0.06779661016949153,1.3862943611198906,4.07753744390572
8651,3,56,Yes,4,8,168,59,224,448,12,60,0.05263157894736842,0.07017543859649122,1.3862943611198906,4.04305126783455
6775,9,60,No,8,8,540,69,480,480,72,68,0.14754098360655737,0.13114754098360656,2.302585092994046,4.110873864173311
6757,5,70,Yes,9,7,350,75,630,490,45,79,0.07042253521126761,0.1267605633802817,1.791759469228055,4.2626798770413155
621,5,77,No,7,0,385,82,539,0,35,84,0.0641025641025641,0.08974358974358974,1.791759469228055,4.356708826689592
2702,7,65,Yes,6,9,455,72,390,585,42,71,0.10606060606060606,0.09090909090909091,2.0794415416798357,4.189654742026425
2200,4,66,No,8,0,264,70,528,0,32,74,0.05970149253731343,0.11940298507462686,1.6094379124341003,4.204692619390966
6197,3,57,Yes,5,7,171,60,285,399,15,62,0.05172413793103448,0.08620689655172414,1.3862943611198906,4.060443010546419
8825,9,65,No,5,1,585,74,325,65,45,70,0.13636363636363635,0.07575757575757576,2.302585092994046,4.189654742026425
1047,4,74,No,7,3,296,78,518,222,28,81,0.05333333333333334,0.09333333333333334,1.6094379124341003,4.31748811353631
5769,6,52,Yes,9,9,312,58,468,468,54,61,0.11320754716981132,0.16981132075471697,1.9459101490553132,3.970291913552122
9948,7,53,No,9,4,371,60,477,212,63,62,0.12962962962962962,0.16666666666666666,2.0794415416798357,3.9889840465642745
9020,6,53,Yes,6,6,318,59,318,318,36,59,0.1111111111111111,0.1111111111111111,1.9459101490553132,3.9889840465642745
744,6,45,Yes,5,3,270,51,225,135,30,50,0.13043478260869565,0.10869565217391304,1.9459101490553132,3.828641396489095
223,6,75,No,4,6,450,81,300,450,24,79,0.07894736842105263,0.05263157894736842,1.9459101490553132,4.330733340286331
3150,4,97,No,5,9,388,101,485,873,20,102,0.04081632653061224,0.05102040816326531,1.6094379124341003,4.584967478670572
626,6,98,No,4,4,588,104,392,392,24,102,0.06060606060606061,0.04040404040404041,1.9459101490553132,4.59511985013459
9335,3,72,No,7,9,216,75,504,648,21,79,0.0410958904109589,0.0958904109589041,1.3862943611198906,4.290459441148391
7567,2,98,No,8,7,196,100,784,686,16,106,0.020202020202020204,0.08080808080808081,1.0986122886681098,4.59511985013459
4583,8,57,Yes,6,7,456,65,342,399,48,63,0.13793103448275862,0.10344827586206896,2.1972245773362196,4.060443010546419
5712,8,66,No,7,2,528,74,462,132,56,73,0.11940298507462686,0.1044776119402985,2.1972245773362196,4.204692619390966
3285,4,66,Yes,8,6,264,70,528,396,32,74,0.05970149253731343,0.11940298507462686,1.6094379124341003,4.204692619390966
7586,5,59,Yes,6,8,295,64,354,472,30,65,0.08333333333333333,0.1,1.791759469228055,4.0943445622221
9647,5,79,Yes,9,2,395,84,711,158,45,88,0.0625,0.1125,1.791759469228055,4.382026634673881
1531,6,77,Yes,8,9,462,83,616,693,48,85,0.07692307692307693,0.10256410256410256,1.9459101490553132,4.356708826689592
9686,1,83,No,6,0,83,84,498,0,6,89,0.011904761904761904,0.07142857142857142,0.6931471805599453,4.430816798843313
354,9,47,No,4,0,423,56,188,0,36,51,0.1875,0.08333333333333333,2.302585092994046,3.871201010907891
2475,6,66,Yes,8,1,396,72,528,66,48,74,0.08955223880597014,0.11940298507462686,1.9459101490553132,4.204692619390966
8014,1,42,No,9,2,42,43,378,84,9,51,0.023255813953488372,0.20930232558139536,0.6931471805599453,3.7612001156935624
6476,3,88,Yes,9,9,264,91,792,792,27,97,0.033707865168539325,0.10112359550561797,1.3862943611198906,4.48863636973214
6450,5,80,No,8,9,400,85,640,720,40,88,0.06172839506172839,0.09876543209876543,1.791759469228055,4.394449154672439
240,2,71,Yes,5,4,142,73,355,284,10,76,0.027777777777777776,0.06944444444444445,1.0986122886681098,4.276666119016055
2626,4,72,Yes,8,9,288,76,576,648,32,80,0.0547945205479452,0.1095890410958904,1.6094379124341003,4.290459441148391
9787,9,77,No,4,0,693,86,308,0,36,81,0.11538461538461539,0.05128205128205128,2.302585092994046,4.356708826689592
7199,7,90,Yes,8,2,630,97,720,180,56,98,0.07692307692307693,0.08791208791208792,2.0794415416798357,4.51085950651685
7693,1,49,Yes,9,9,49,50,441,441,9,58,0.02,0.18,0.6931471805599453,3.912023005428146
2998,3,84,Yes,5,2,252,87,420,168,15,89,0.03529411764705882,0.058823529411764705,1.3862943611198906,4.442651256490317
6441,8,73,No,5,4,584,81,365,292,40,78,0.10810810810810811,0.06756756756756757,2.1972245773362196,4.30406509320417
4563,8,81,No,4,3,648,89,324,243,32,85,0.0975609756097561,0.04878048780487805,2.1972245773362196,4.406719247264253
8615,5,66,Yes,5,5,330,71,330,330,25,71,0.07462686567164178,0.07462686567164178,1.791759469228055,4.204692619390966
1480,4,56,Yes,5,1,224,60,280,56,20,61,0.07017543859649122,0.08771929824561403,1.6094379124341003,4.04305126783455
1019,5,55,Yes,6,8,275,60,330,440,30,61,0.08928571428571429,0.10714285714285714,1.791759469228055,4.02535169073515
3095,6,84,Yes,4,5,504,90,336,420,24,88,0.07058823529411765,0.047058823529411764,1.9459101490553132,4.442651256490317
6183,3,48,Yes,6,6,144,51,288,288,18,54,0.061224489795918366,0.12244897959183673,1.3862943611198906,3.8918202981106265
4961,9,58,Yes,7,2,522,67,406,116,63,65,0.15254237288135594,0.11864406779661017,2.302585092994046,4.07753744390572
8493,3,71,No,5,3,213,74,355,213,15,76,0.041666666666666664,0.06944444444444445,1.3862943611198906,4.276666119016055
1104,7,50,Yes,6,4,350,57,300,200,42,56,0.13725490196078433,0.11764705882352941,2.0794415416798357,3.9318256327243257
6082,6,61,No,6,0,366,67,366,0,36,67,0.0967741935483871,0.0967741935483871,1.9459101490553132,4.127134385045092
9526,8,49,No,9,1,392,57,441,49,72,58,0.16,0.18,2.1972245773362196,3.912023005428146
5191,2,60,No,6,6,120,62,360,360,12,66,0.03278688524590164,0.09836065573770492,1.0986122886681098,4.110873864173311
4182,9,94,Yes,8,5,846,103,752,470,72,102,0.09473684210526316,0.08421052631578947,2.302585092994046,4.553876891600541
4468,7,40,No,6,2,280,47,240,80,42,46,0.17073170731707318,0.14634146341463414,2.0794415416798357,3.713572066704308
1627,5,84,No,5,3,420,89,420,252,25,89,0.058823529411764705,0.058823529411764705,1.791759469228055,4.442651256490317
6718,9,55,Yes,5,7,495,64,275,385,45,60,0.16071428571428573,0.08928571428571429,2.302585092994046,4.02535169073515
3799,7,71,Yes,5,8,497,78,355,568,35,76,0.09722222222222222,0.06944444444444445,2.0794415416798357,4.276666119016055
3054,4,87,Yes,6,3,348,91,522,261,24,93,0.045454545454545456,0.06818181818181818,1.6094379124341003,4.477336814478207
2868,6,73,Yes,6,2,438,79,438,146,36,79,0.08108108108108109,0.08108108108108109,1.9459101490553132,4.30406509320417
1433,1,53,Yes,4,2,53,54,212,106,4,57,0.018518518518518517,0.07407407407407407,0.6931471805599453,3.9889840465642745
7984,5,48,Yes,8,6,240,53,384,288,40,56,0.10204081632653061,0.16326530612244897,1.791759469228055,3.8918202981106265
9347,9,89,Yes,9,4,801,98,801,356,81,98,0.1,0.1,2.302585092994046,4.499809670330265
9420,6,66,No,6,9,396,72,396,594,36,72,0.08955223880597014,0.08955223880597014,1.9459101490553132,4.204692619390966
4077,6,62,Yes,5,8,372,68,310,496,30,67,0.09523809523809523,0.07936507936507936,1.9459101490553132,4.143134726391533
218,3,93,Yes,7,1,279,96,651,93,21,100,0.031914893617021274,0.07446808510638298,1.3862943611198906,4.543294782270004
3556,6,44,No,8,3,264,50,352,132,48,52,0.13333333333333333,0.17777777777777778,1.9459101490553132,3.8066624897703196
7937,1,81,No,6,4,81,82,486,324,6,87,0.012195121951219513,0.07317073170731707,0.6931471805599453,4.406719247264253
8422,5,92,No,4,8,460,97,368,736,20,96,0.053763440860215055,0.043010752688172046,1.791759469228055,4.532599493153256
1035,2,48,Yes,9,1,96,50,432,48,18,57,0.04081632653061224,0.1836734693877551,1.0986122886681098,3.8918202981106265
3774,4,89,No,6,3,356,93,534,267,24,95,0.044444444444444446,0.06666666666666667,1.6094379124341003,4.499809670330265
4133,1,71,Yes,4,1,71,72,284,71,4,75,0.013888888888888888,0.05555555555555555,0.6931471805599453,4.276666119016055
2336,6,91,No,6,2,546,97,546,182,36,97,0.06521739130434782,0.06521739130434782,1.9459101490553132,4.5217885770490405
6493,4,99,No,9,5,396,103,891,495,36,108,0.04,0.09,1.6094379124341003,4.605170185988092
1483,3,97,Yes,9,1,291,100,873,97,27,106,0.030612244897959183,0.09183673469387756,1.3862943611198906,4.584967478670572
907,9,96,Yes,5,8,864,105,480,768,45,101,0.09278350515463918,0.05154639175257732,2.302585092994046,4.574710978503383
6089,5,42,Yes,6,9,210,47,252,378,30,48,0.11627906976744186,0.13953488372093023,1.791759469228055,3.7612001156935624
6467,6,80,Yes,8,4,480,86,640,320,48,88,0.07407407407407407,0.09876543209876543,1.9459101490553132,4.394449154672439
5677,8,91,Yes,7,6,728,99,637,546,56,98,0.08695652173913043,0.07608695652173914,2.1972245773362196,4.5217885770490405
2771,3,83,No,6,2,249,86,498,166,18,89,0.03571428571428571,0.07142857142857142,1.3862943611198906,4.430816798843313
1806,1,52,Yes,7,0,52,53,364,0,7,59,0.018867924528301886,0.1320754716981132,0.6931471805599453,3.970291913552122
7375,4,88,No,4,0,352,92,352,0,16,92,0.0449438202247191,0.0449438202247191,1.6094379124341003,4.48863636973214
2115,8,55,No,8,3,440,63,440,165,64,63,0.14285714285714285,0.14285714285714285,2.1972245773362196,4.02535169073515
4535,6,47,No,9,8,282,53,423,376,54,56,0.125,0.1875,1.9459101490553132,3.871201010907891
2532,6,51,No,9,1,306,57,459,51,54,60,0.11538461538461539,0.17307692307692307,1.9459101490553132,3.9512437185814275
8526,6,55,No,4,6,330,61,220,330,24,59,0.10714285714285714,0.07142857142857142,1.9459101490553132,4.02535169073515
3471,1,99,Yes,7,3,99,100,693,297,7,106,0.01,0.07,0.6931471805599453,4.605170185988092
1403,2,52,Yes,8,9,104,54,416,468,16,60,0.03773584905660377,0.1509433962264151,1.0986122886681098,3.970291913552122
853,8,94,No,8,6,752,102,752,564,64,102,0.08421052631578947,0.08421052631578947,2.1972245773362196,4.553876891600541
3083,1,67,No,9,3,67,68,603,201,9,76,0.014705882352941176,0.1323529411764706,0.6931471805599453,4.219507705176107
8025,7,86,Yes,5,5,602,93,430,430,35,91,0.08045977011494253,0.05747126436781609,2.0794415416798357,4.465908118654584
7566,6,88,Yes,5,8,528,94,440,704,30,93,0.06741573033707865,0.056179775280898875,1.9459101490553132,4.48863636973214
5530,5,95,Yes,9,0,475,100,855,0,45,104,0.052083333333333336,0.09375,1.791759469228055,4.564348191467836
7855,6,53,No,9,9,318,59,477,477,54,62,0.1111111111111111,0.16666666666666666,1.9459101490553132,3.9889840465642745
4933,8,44,No,4,3,352,52,176,132,32,48,0.17777777777777778,0.08888888888888889,2.1972245773362196,3.8066624897703196
5160,7,91,Yes,4,9,637,98,364,819,28,95,0.07608695652173914,0.043478260869565216,2.0794415416798357,4.5217885770490405
9716,4,87,Yes,9,7,348,91,783,609,36,96,0.045454545454545456,0.10227272727272728,1.6094379124341003,4.477336814478207
3847,5,69,Yes,6,0,345,74,414,0,30,75,0.07142857142857142,0.08571428571428572,1.791759469228055,4.248495242049359
6484,7,45,No,8,3,315,52,360,135,56,53,0.15217391304347827,0.17391304347826086,2.0794415416798357,3.828641396489095
748,7,53,No,9,1,371,60,477,53,63,62,0.12962962962962962,0.16666666666666666,2.0794415416798357,3.9889840465642745
3035,9,54,Yes,4,4,486,63,216,216,36,58,0.16363636363636364,0.07272727272727272,2.302585092994046,4.007333185232471
348,8,66,Yes,7,7,528,74,462,462,56,73,0.11940298507462686,0.1044776119402985,2.1972245773362196,4.204692619390966
3352,6,43,Yes,4,3,258,49,172,129,24,47,0.13636363636363635,0.09090909090909091,1.9459101490553132,3.784189633918261
2865,1,98,No,9,0,98,99,882,0,9,107,0.010101010101010102,0.09090909090909091,0.6931471805599453,4.59511985013459
2168,3,66,No,9,9,198,69,594,594,27,75,0.04477611940298507,0.13432835820895522,1.3862943611198906,4.204692619390966
6955,9,81,Yes,7,9,729,90,567,729,63,88,0.10975609756097561,0.08536585365853659,2.302585092994046,4.406719247264253
6210,6,51,No,4,4,306,57,204,204,24,55,0.11538461538461539,0.07692307692307693,1.9459101490553132,3.9512437185814275
2778,4,63,Yes,9,9,252,67,567,567,36,72,0.0625,0.140625,1.6094379124341003,4.1588830833596715
1442,9,42,Yes,8,9,378,51,336,378,72,50,0.20930232558139536,0.18604651162790697,2.302585092994046,3.7612001156935624
5658,1,46,Yes,9,4,46,47,414,184,9,55,0.02127659574468085,0.19148936170212766,0.6931471805599453,3.8501476017100584
9658,6,79,No,9,6,474,85,711,474,54,88,0.075,0.1125,1.9459101490553132,4.382026634673881
3028,7,69,No,9,2,483,76,621,138,63,78,0.1,0.12857142857142856,2.0794415416798357,4.248495242049359
6118,7,40,No,6,0,280,47,240,0,42,46,0.17073170731707318,0.14634146341463414,2.0794415416798357,3.713572066704308
2484,9,58,No,7,5,522,67,406,290,63,65,0.15254237288135594,0.11864406779661017,2.302585092994046,4.07753744390572
2883,9,51,No,8,3,459,60,408,153,72,59,0.17307692307692307,0.15384615384615385,2.302585092994046,3.9512437185814275
5562,1,83,No,5,3,83,84,415,249,5,88,0.011904761904761904,0.05952380952380952,0.6931471805599453,4.430816798843313
764,8,99,No,4,8,792,107,396,792,32,103,0.08,0.04,2.1972245773362196,4.605170185988092
6482,1,91,No,8,1,91,92,728,91,8,99,0.010869565217391304,0.08695652173913043,0.6931471805599453,4.5217885770490405
1617,2,75,Yes,7,3,150,77,525,225,14,82,0.02631578947368421,0.09210526315789473,1.0986122886681098,4.330733340286331
1223,2,74,No,5,1,148,76,370,74,10,79,0.02666666666666667,0.06666666666666667,1.0986122886681098,4.31748811353631
8665,4,90,Yes,6,8,360,94,540,720,24,96,0.04395604395604396,0.06593406593406594,1.6094379124341003,4.51085950651685
6222,6,53,Yes,6,9,318,59,318,477,36,59,0.1111111111111111,0.1111111111111111,1.9459101490553132,3.9889840465642745
1577,8,94,Yes,6,5,752,102,564,470,48,100,0.08421052631578947,0.06315789473684211,2.1972245773362196,4.553876891600541
9392,6,70,Yes,7,2,420,76,490,140,42,77,0.08450704225352113,0.09859154929577464,1.9459101490553132,4.2626798770413155
6351,9,83,No,7,3,747,92,581,249,63,90,0.10714285714285714,0.08333333333333333,2.302585092994046,4.430816798843313
3783,3,59,No,4,2,177,62,236,118,12,63,0.05,0.06666666666666667,1.3862943611198906,4.0943445622221
4375,1,77,No,8,7,77,78,616,539,8,85,0.01282051282051282,0.10256410256410256,0.6931471805599453,4.356708826689592
709,5,61,No,7,0,305,66,427,0,35,68,0.08064516129032258,0.11290322580645161,1.791759469228055,4.127134385045092
510,9,46,Yes,7,3,414,55,322,138,63,53,0.19148936170212766,0.14893617021276595,2.302585092994046,3.8501476017100584
2955,6,81,Yes,4,1,486,87,324,81,24,85,0.07317073170731707,0.04878048780487805,1.9459101490553132,4.406719247264253
7538,5,77,Yes,5,8,385,82,385,616,25,82,0.0641025641025641,0.0641025641025641,1.791759469228055,4.356708826689592
6339,8,58,No,7,5,464,66,406,290,56,65,0.13559322033898305,0.11864406779661017,2.1972245773362196,4.07753744390572
8923,5,84,Yes,5,0,420,89,420,0,25,89,0.058823529411764705,0.058823529411764705,1.791759469228055,4.442651256490317
7064,5,90,Yes,5,9,450,95,450,810,25,95,0.054945054945054944,0.054945054945054944,1.791759469228055,4.51085950651685
7163,7,97,No,4,1,679,104,388,97,28,101,0.07142857142857142,0.04081632653061224,2.0794415416798357,4.584967478670572
7372,7,86,No,9,1,602,93,774,86,63,95,0.08045977011494253,0.10344827586206896,2.0794415416798357,4.465908118654584
6829,7,53,No,8,8,371,60,424,424,56,61,0.12962962962962962,0.14814814814814814,2.0794415416798357,3.9889840465642745
3616,2,40,No,8,1,80,42,320,40,16,48,0.04878048780487805,0.1951219512195122,1.0986122886681098,3.713572066704308
4657,7,95,Yes,8,4,665,102,760,380,56,103,0.07291666666666667,0.08333333333333333,2.0794415416798357,4.564348191467836
6976,1,41,No,7,3,41,42,287,123,7,48,0.023809523809523808,0.16666666666666666,0.6931471805599453,3.7376696182833684
4351,7,90,Yes,6,4,630,97,540,360,42,96,0.07692307692307693,0.06593406593406594,2.0794415416798357,4.51085950651685
712,1,82,Yes,5,5,82,83,410,410,5,87,0.012048192771084338,0.060240963855421686,0.6931471805599453,4.418840607796598
6479,5,96,No,4,1,480,101,384,96,20,100,0.05154639175257732,0.041237113402061855,1.791759469228055,4.574710978503383
9130,3,76,No,9,8,228,79,684,608,27,85,0.03896103896103896,0.11688311688311688,1.3862943611198906,4.343805421853684
8205,2,55,Yes,8,8,110,57,440,440,16,63,0.03571428571428571,0.14285714285714285,1.0986122886681098,4.02535169073515
9204,3,41,No,8,7,123,44,328,287,24,49,0.07142857142857142,0.19047619047619047,1.3862943611198906,3.7376696182833684
713,7,43,No,5,3,301,50,215,129,35,48,0.1590909090909091,0.11363636363636363,2.0794415416798357,3.784189633918261
9113,8,56,No,8,8,448,64,448,448,64,64,0.14035087719298245,0.14035087719298245,2.1972245773362196,4.04305126783455
1246,6,41,Yes,5,8,246,47,205,328,30,46,0.14285714285714285,0.11904761904761904,1.9459101490553132,3.7376696182833684
9786,3,55,No,5,7,165,58,275,385,15,60,0.05357142857142857,0.08928571428571429,1.3862943611198906,4.02535169073515
6849,3,80,No,8,8,240,83,640,640,24,88,0.037037037037037035,0.09876543209876543,1.3862943611198906,4.394449154672439
5134,4,43,No,8,2,172,47,344,86,32,51,0.09090909090909091,0.18181818181818182,1.6094379124341003,3.784189633918261
716,1,71,Yes,6,5,71,72,426,355,6,77,0.013888888888888888,0.08333333333333333,0.6931471805599453,4.276666119016055
3464,9,60,Yes,7,7,540,69,420,420,63,67,0.14754098360655737,0.11475409836065574,2.302585092994046,4.110873864173311
4395,7,90,No,4,8,630,97,360,720,28,94,0.07692307692307693,0.04395604395604396,2.0794415416798357,4.51085950651685
4569,7,47,No,8,1,329,54,376,47,56,55,0.14583333333333334,0.16666666666666666,2.0794415416798357,3.871201010907891
8804,2,67,Yes,6,9,134,69,402,603,12,73,0.029411764705882353,0.08823529411764706,1.0986122886681098,4.219507705176107
8490,4,65,Yes,9,2,260,69,585,130,36,74,0.06060606060606061,0.13636363636363635,1.6094379124341003,4.189654742026425
7702,2,98,No,9,7,196,100,882,686,18,107,0.020202020202020204,0.09090909090909091,1.0986122886681098,4.59511985013459
213,5,41,No,8,4,205,46,328,164,40,49,0.11904761904761904,0.19047619047619047,1.791759469228055,3.7376696182833684
9768,8,76,Yes,5,1,608,84,380,76,40,81,0.1038961038961039,0.06493506493506493,2.1972245773362196,4.343805421853684
6839,1,53,Yes,6,0,53,54,318,0,6,59,0.018518518518518517,0.1111111111111111,0.6931471805599453,3.9889840465642745
1011,2,48,No,4,0,96,50,192,0,8,52,0.04081632653061224,0.08163265306122448,1.0986122886681098,3.8918202981106265
324,3,78,Yes,6,1,234,81,468,78,18,84,0.0379746835443038,0.0759493670886076,1.3862943611198906,4.3694478524670215
5397,9,58,Yes,4,2,522,67,232,116,36,62,0.15254237288135594,0.06779661016949153,2.302585092994046,4.07753744390572
5991,1,93,Yes,5,9,93,94,465,837,5,98,0.010638297872340425,0.05319148936170213,0.6931471805599453,4.543294782270004
3173,6,71,Yes,6,9,426,77,426,639,36,77,0.08333333333333333,0.08333333333333333,1.9459101490553132,4.276666119016055
335,5,44,No,6,0,220,49,264,0,30,50,0.1111111111111111,0.13333333333333333,1.791759469228055,3.8066624897703196
8306,1,66,Yes,9,3,66,67,594,198,9,75,0.014925373134328358,0.13432835820895522,0.6931471805599453,4.204692619390966
2211,6,91,Yes,4,1,546,97,364,91,24,95,0.06521739130434782,0.043478260869565216,1.9459101490553132,4.5217885770490405
4272,9,43,Yes,9,9,387,52,387,387,81,52,0.20454545454545456,0.20454545454545456,2.302585092994046,3.784189633918261
6741,1,60,No,5,1,60,61,300,60,5,65,0.01639344262295082,0.08196721311475409,0.6931471805599453,4.110873864173311
234,3,79,Yes,9,2,237,82,711,158,27,88,0.0375,0.1125,1.3862943611198906,4.382026634673881
5951,1,48,Yes,7,0,48,49,336,0,7,55,0.02040816326530612,0.14285714285714285,0.6931471805599453,3.8918202981106265
5738,8,41,Yes,5,0,328,49,205,0,40,46,0.19047619047619047,0.11904761904761904,2.1972245773362196,3.7376696182833684
7922,4,87,No,4,0,348,91,348,0,16,91,0.045454545454545456,0.045454545454545456,1.6094379124341003,4.477336814478207
2349,8,69,No,7,1,552,77,483,69,56,76,0.11428571428571428,0.1,2.1972245773362196,4.248495242049359
2037,3,58,Yes,5,0,174,61,290,0,15,63,0.05084745762711865,0.0847457627118644,1.3862943611198906,4.07753744390572
7485,4,87,No,5,0,348,91,435,0,20,92,0.045454545454545456,0.056818181818181816,1.6094379124341003,4.477336814478207
6007,7,85,No,9,5,595,92,765,425,63,94,0.08139534883720931,0.10465116279069768,2.0794415416798357,4.454347296253507
4554,3,66,No,6,8,198,69,396,528,18,72,0.04477611940298507,0.08955223880597014,1.3862943611198906,4.204692619390966
8073,1,57,Yes,5,0,57,58,285,0,5,62,0.017241379310344827,0.08620689655172414,0.6931471805599453,4.060443010546419
1459,6,72,Yes,7,5,432,78,504,360,42,79,0.0821917808219178,0.0958904109589041,1.9459101490553132,4.290459441148391
3289,4,49,No,8,7,196,53,392,343,32,57,0.08,0.16,1.6094379124341003,3.912023005428146
3065,3,93,Yes,9,5,279,96,837,465,27,102,0.031914893617021274,0.09574468085106383,1.3862943611198906,4.543294782270004
9437,6,55,No,6,9,330,61,330,495,36,61,0.10714285714285714,0.10714285714285714,1.9459101490553132,4.02535169073515
775,3,64,Yes,4,7,192,67,256,448,12,68,0.046153846153846156,0.06153846153846154,1.3862943611198906,4.174387269895637
6833,3,93,Yes,9,1,279,96,837,93,27,102,0.031914893617021274,0.09574468085106383,1.3862943611198906,4.543294782270004
872,4,62,No,9,5,248,66,558,310,36,71,0.06349206349206349,0.14285714285714285,1.6094379124341003,4.143134726391533
8750,1,59,Yes,5,4,59,60,295,236,5,64,0.016666666666666666,0.08333333333333333,0.6931471805599453,4.0943445622221
1264,1,48,No,9,2,48,49,432,96,9,57,0.02040816326530612,0.1836734693877551,0.6931471805599453,3.8918202981106265
4834,5,51,No,7,1,255,56,357,51,35,58,0.09615384615384616,0.1346153846153846,1.791759469228055,3.9512437185814275
3895,5,90,Yes,8,7,450,95,720,630,40,98,0.054945054945054944,0.08791208791208792,1.791759469228055,4.51085950651685
6324,6,82,Yes,7,2,492,88,574,164,42,89,0.07228915662650602,0.08433734939759036,1.9459101490553132,4.418840607796598
9213,2,70,Yes,9,3,140,72,630,210,18,79,0.028169014084507043,0.1267605633802817,1.0986122886681098,4.2626798770413155
7020,2,45,Yes,6,3,90,47,270,135,12,51,0.043478260869565216,0.13043478260869565,1.0986122886681098,3.828641396489095
1221,2,69,No,8,0,138,71,552,0,16,77,0.02857142857142857,0.11428571428571428,1.0986122886681098,4.248495242049359
1447,8,60,No,5,2,480,68,300,120,40,65,0.13114754098360656,0.08196721311475409,2.1972245773362196,4.110873864173311
3185,8,58,No,5,3,464,66,290,174,40,63,0.13559322033898305,0.0847457627118644,2.1972245773362196,4.07753744390572
409,2,70,Yes,7,7,140,72,490,490,14,77,0.028169014084507043,0.09859154929577464,1.0986122886681098,4.2626798770413155
4345,8,40,No,6,3,320,48,240,120,48,46,0.1951219512195122,0.14634146341463414,2.1972245773362196,3.713572066704308
3022,3,57,No,6,3,171,60,342,171,18,63,0.05172413793103448,0.10344827586206896,1.3862943611198906,4.060443010546419
2304,2,60,No,9,0,120,62,540,0,18,69,0.03278688524590164,0.14754098360655737,1.0986122886681098,4.110873864173311
6272,3,94,No,5,6,282,97,470,564,15,99,0.031578947368421054,0.05263157894736842,1.3862943611198906,4.553876891600541
8281,9,44,Yes,8,6,396,53,352,264,72,52,0.2,0.17777777777777778,2.302585092994046,3.8066624897703196
6642,7,74,Yes,6,9,518,81,444,666,42,80,0.09333333333333334,0.08,2.0794415416798357,4.31748811353631
6956,3,82,Yes,7,8,246,85,574,656,21,89,0.03614457831325301,0.08433734939759036,1.3862943611198906,4.418840607796598
2110,1,78,No,8,0,78,79,624,0,8,86,0.012658227848101266,0.10126582278481013,0.6931471805599453,4.3694478524670215
5352,7,54,No,6,7,378,61,324,378,42,60,0.12727272727272726,0.10909090909090909,2.0794415416798357,4.007333185232471
9684,6,65,Yes,6,1,390,71,390,65,36,71,0.09090909090909091,0.09090909090909091,1.9459101490553132,4.189654742026425
8344,7,80,No,6,9,560,87,480,720,42,86,0.08641975308641975,0.07407407407407407,2.0794415416798357,4.394449154672439
4550,9,50,No,8,1,450,59,400,50,72,58,0.17647058823529413,0.1568627450980392,2.302585092994046,3.9318256327243257
1881,9,55,No,7,7,495,64,385,385,63,62,0.16071428571428573,0.125,2.302585092994046,4.02535169073515
5946,6,92,No,5,2,552,98,460,184,30,97,0.06451612903225806,0.053763440860215055,1.9459101490553132,4.532599493153256
1738,4,67,Yes,6,3,268,71,402,201,24,73,0.058823529411764705,0.08823529411764706,1.6094379124341003,4.219507705176107
7794,9,42,No,7,3,378,51,294,126,63,49,0.20930232558139536,0.16279069767441862,2.302585092994046,3.7612001156935624
5213,5,78,Yes,7,9,390,83,546,702,35,85,0.06329113924050633,0.08860759493670886,1.791759469228055,4.3694478524670215
3209,7,54,Yes,4,9,378,61,216,486,28,58,0.12727272727272726,0.07272727272727272,2.0794415416798357,4.007333185232471
7083,3,96,Yes,9,4,288,99,864,384,27,105,0.030927835051546393,0.09278350515463918,1.3862943611198906,4.574710978503383
2056,4,77,Yes,9,7,308,81,693,539,36,86,0.05128205128205128,0.11538461538461539,1.6094379124341003,4.356708826689592
1689,3,86,Yes,6,9,258,89,516,774,18,92,0.034482758620689655,0.06896551724137931,1.3862943611198906,4.465908118654584
4780,9,49,No,5,3,441,58,245,147,45,54,0.18,0.1,2.302585092994046,3.912023005428146
7476,6,64,Yes,4,3,384,70,256,192,24,68,0.09230769230769231,0.06153846153846154,1.9459101490553132,4.174387269895637
7877,9,41,Yes,7,7,369,50,287,287,63,48,0.21428571428571427,0.16666666666666666,2.302585092994046,3.7376696182833684
6750,3,98,Yes,7,8,294,101,686,784,21,105,0.030303030303030304,0.0707070707070707,1.3862943611198906,4.59511985013459
8556,1,53,Yes,7,9,53,54,371,477,7,60,0.018518518518518517,0.12962962962962962,0.6931471805599453,3.9889840465642745
8123,1,51,Yes,5,2,51,52,255,102,5,56,0.019230769230769232,0.09615384615384616,0.6931471805599453,3.9512437185814275
6991,8,83,Yes,4,1,664,91,332,83,32,87,0.09523809523809523,0.047619047619047616,2.1972245773362196,4.430816798843313
8267,6,79,Yes,9,9,474,85,711,711,54,88,0.075,0.1125,1.9459101490553132,4.382026634673881
8540,2,40,Yes,5,3,80,42,200,120,10,45,0.04878048780487805,0.12195121951219512,1.0986122886681098,3.713572066704308
3393,5,40,No,6,4,200,45,240,160,30,46,0.12195121951219512,0.14634146341463414,1.791759469228055,3.713572066704308
6326,8,97,Yes,9,0,776,105,873,0,72,106,0.08163265306122448,0.09183673469387756,2.1972245773362196,4.584967478670572
3529,1,93,No,8,5,93,94,744,465,8,101,0.010638297872340425,0.0851063829787234,0.6931471805599453,4.543294782270004
4605,4,81,Yes,8,4,324,85,648,324,32,89,0.04878048780487805,0.0975609756097561,1.6094379124341003,4.406719247264253
7024,7,81,No,6,9,567,88,486,729,42,87,0.08536585365853659,0.07317073170731707,2.0794415416798357,4.406719247264253
6322,6,74,Yes,9,1,444,80,666,74,54,83,0.08,0.12,1.9459101490553132,4.31748811353631
746,4,46,Yes,5,4,184,50,230,184,20,51,0.0851063829787234,0.10638297872340426,1.6094379124341003,3.8501476017100584
711,9,46,No,7,5,414,55,322,230,63,53,0.19148936170212766,0.14893617021276595,2.302585092994046,3.8501476017100584
380,1,99,Yes,4,6,99,100,396,594,4,103,0.01,0.04,0.6931471805599453,4.605170185988092
8783,8,77,No,9,0,616,85,693,0,72,86,0.10256410256410256,0.11538461538461539,2.1972245773362196,4.356708826689592
3012,5,67,No,8,4,335,72,536,268,40,75,0.07352941176470588,0.11764705882352941,1.791759469228055,4.219507705176107
8859,3,73,Yes,7,8,219,76,511,584,21,80,0.04054054054054054,0.0945945945945946,1.3862943611198906,4.30406509320417
7153,8,60,Yes,6,2,480,68,360,120,48,66,0.13114754098360656,0.09836065573770492,2.1972245773362196,4.110873864173311
8567,4,46,No,8,4,184,50,368,184,32,54,0.0851063829787234,0.1702127659574468,1.6094379124341003,3.8501476017100584
3498,3,83,No,7,0,249,86,581,0,21,90,0.03571428571428571,0.08333333333333333,1.3862943611198906,4.430816798843313
3890,4,96,Yes,8,9,384,100,768,864,32,104,0.041237113402061855,0.08247422680412371,1.6094379124341003,4.574710978503383
4485,8,85,Yes,8,7,680,93,680,595,64,93,0.09302325581395349,0.09302325581395349,2.1972245773362196,4.454347296253507
4012,8,97,Yes,5,7,776,105,485,679,40,102,0.08163265306122448,0.05102040816326531,2.1972245773362196,4.584967478670572
2620,8,82,No,8,7,656,90,656,574,64,90,0.0963855421686747,0.0963855421686747,2.1972245773362196,4.418840607796598
6671,6,54,No,8,6,324,60,432,324,48,62,0.10909090909090909,0.14545454545454545,1.9459101490553132,4.007333185232471
6513,4,64,No,6,1,256,68,384,64,24,70,0.06153846153846154,0.09230769230769231,1.6094379124341003,4.174387269895637
3468,2,84,No,7,9,168,86,588,756,14,91,0.023529411764705882,0.08235294117647059,1.0986122886681098,4.442651256490317
1314,9,61,No,8,2,549,70,488,122,72,69,0.14516129032258066,0.12903225806451613,2.302585092994046,4.127134385045092
8606,7,58,No,4,2,406,65,232,116,28,62,0.11864406779661017,0.06779661016949153,2.0794415416798357,4.07753744390572
2070,9,73,No,4,4,657,82,292,292,36,77,0.12162162162162163,0.05405405405405406,2.302585092994046,4.30406509320417
2983,2,86,No,9,7,172,88,774,602,18,95,0.022988505747126436,0.10344827586206896,1.0986122886681098,4.465908118654584
5915,5,57,No,7,7,285,62,399,399,35,64,0.08620689655172414,0.1206896551724138,1.791759469228055,4.060443010546419
9171,2,77,Yes,8,6,154,79,616,462,16,85,0.02564102564102564,0.10256410256410256,1.0986122886681098,4.356708826689592
1286,9,67,No,4,4,603,76,268,268,36,71,0.1323529411764706,0.058823529411764705,2.302585092994046,4.219507705176107
8991,2,48,Yes,8,0,96,50,384,0,16,56,0.04081632653061224,0.16326530612244897,1.0986122886681098,3.8918202981106265
8430,2,44,Yes,5,9,88,46,220,396,10,49,0.044444444444444446,0.1111111111111111,1.0986122886681098,3.8066624897703196
1350,1,94,Yes,4,7,94,95,376,658,4,98,0.010526315789473684,0.042105263157894736,0.6931471805599453,4.553876891600541
2612,3,48,Yes,9,7,144,51,432,336,27,57,0.061224489795918366,0.1836734693877551,1.3862943611198906,3.8918202981106265
9495,8,63,No,5,6,504,71,315,378,40,68,0.125,0.078125,2.1972245773362196,4.1588830833596715
3669,3,89,Yes,8,8,267,92,712,712,24,97,0.03333333333333333,0.08888888888888889,1.3862943611198906,4.499809670330265
2222,1,91,No,7,6,91,92,637,546,7,98,0.010869565217391304,0.07608695652173914,0.6931471805599453,4.5217885770490405
428,4,44,No,6,1,176,48,264,44,24,50,0.08888888888888889,0.13333333333333333,1.6094379124341003,3.8066624897703196
654,3,95,Yes,5,1,285,98,475,95,15,100,0.03125,0.052083333333333336,1.3862943611198906,4.564348191467836
9914,2,53,Yes,5,9,106,55,265,477,10,58,0.037037037037037035,0.09259259259259259,1.0986122886681098,3.9889840465642745
3536,8,65,Yes,8,4,520,73,520,260,64,73,0.12121212121212122,0.12121212121212122,2.1972245773362196,4.189654742026425
7737,6,54,Yes,6,0,324,60,324,0,36,60,0.10909090909090909,0.10909090909090909,1.9459101490553132,4.007333185232471
3246,3,61,No,4,5,183,64,244,305,12,65,0.04838709677419355,0.06451612903225806,1.3862943611198906,4.127134385045092
4741,2,64,Yes,7,0,128,66,448,0,14,71,0.03076923076923077,0.1076923076923077,1.0986122886681098,4.174387269895637
9069,4,89,No,4,3,356,93,356,267,16,93,0.044444444444444446,0.044444444444444446,1.6094379124341003,4.499809670330265
4100,5,63,No,6,0,315,68,378,0,30,69,0.078125,0.09375,1.791759469228055,4.1588830833596715
4101,4,45,No,7,7,180,49,315,315,28,52,0.08695652173913043,0.15217391304347827,1.6094379124341003,3.828641396489095
6960,2,75,Yes,8,2,150,77,600,150,16,83,0.02631578947368421,0.10526315789473684,1.0986122886681098,4.330733340286331
612,6,69,No,8,0,414,75,552,0,48,77,0.08571428571428572,0.11428571428571428,1.9459101490553132,4.248495242049359
4289,2,52,No,8,4,104,54,416,208,16,60,0.03773584905660377,0.1509433962264151,1.0986122886681098,3.970291913552122
8571,8,80,No,5,1,640,88,400,80,40,85,0.09876543209876543,0.06172839506172839,2.1972245773362196,4.394449154672439
9713,6,41,No,9,3,246,47,369,123,54,50,0.14285714285714285,0.21428571428571427,1.9459101490553132,3.7376696182833684
1544,7,46,No,5,2,322,53,230,92,35,51,0.14893617021276595,0.10638297872340426,2.0794415416798357,3.8501476017100584
9536,1,79,No,4,1,79,80,316,79,4,83,0.0125,0.05,0.6931471805599453,4.382026634673881
3854,6,67,No,4,8,402,73,268,536,24,71,0.08823529411764706,0.058823529411764705,1.9459101490553132,4.219507705176107
555,1,58,No,8,0,58,59,464,0,8,66,0.01694915254237288,0.13559322033898305,0.6931471805599453,4.07753744390572
6366,7,85,Yes,9,7,595,92,765,595,63,94,0.08139534883720931,0.10465116279069768,2.0794415416798357,4.454347296253507
512,1,53,Yes,8,5,53,54,424,265,8,61,0.018518518518518517,0.14814814814814814,0.6931471805599453,3.9889840465642745
3207,4,55,No,7,0,220,59,385,0,28,62,0.07142857142857142,0.125,1.6094379124341003,4.02535169073515
8085,9,73,Yes,4,5,657,82,292,365,36,77,0.12162162162162163,0.05405405405405406,2.302585092994046,4.30406509320417
968,8,87,Yes,5,6,696,95,435,522,40,92,0.09090909090909091,0.056818181818181816,2.1972245773362196,4.477336814478207
6044,9,42,Yes,9,3,378,51,378,126,81,51,0.20930232558139536,0.20930232558139536,2.302585092994046,3.7612001156935624
6880,7,81,No,6,8,567,88,486,648,42,87,0.08536585365853659,0.07317073170731707,2.0794415416798357,4.406719247264253
6776,3,84,No,9,0,252,87,756,0,27,93,0.03529411764705882,0.10588235294117647,1.3862943611198906,4.442651256490317
3296,3,87,No,8,1,261,90,696,87,24,95,0.03409090909090909,0.09090909090909091,1.3862943611198906,4.477336814478207
8702,6,60,No,8,7,360,66,480,420,48,68,0.09836065573770492,0.13114754098360656,1.9459101490553132,4.110873864173311
3430,4,81,No,4,1,324,85,324,81,16,85,0.04878048780487805,0.04878048780487805,1.6094379124341003,4.406719247264253
8871,8,87,No,6,7,696,95,522,609,48,93,0.09090909090909091,0.06818181818181818,2.1972245773362196,4.477336814478207
6963,3,76,Yes,7,4,228,79,532,304,21,83,0.03896103896103896,0.09090909090909091,1.3862943611198906,4.343805421853684
2089,2,82,No,6,8,164,84,492,656,12,88,0.024096385542168676,0.07228915662650602,1.0986122886681098,4.418840607796598
8500,9,52,Yes,8,7,468,61,416,364,72,60,0.16981132075471697,0.1509433962264151,2.302585092994046,3.970291913552122
6163,8,92,No,5,7,736,100,460,644,40,97,0.08602150537634409,0.053763440860215055,2.1972245773362196,4.532599493153256
3211,4,97,Yes,4,3,388,101,388,291,16,101,0.04081632653061224,0.04081632653061224,1.6094379124341003,4.584967478670572
9201,9,60,Yes,7,0,540,69,420,0,63,67,0.14754098360655737,0.11475409836065574,2.302585092994046,4.110873864173311
6606,9,55,Yes,7,3,495,64,385,165,63,62,0.16071428571428573,0.125,2.302585092994046,4.02535169073515
1110,8,56,Yes,6,1,448,64,336,56,48,62,0.14035087719298245,0.10526315789473684,2.1972245773362196,4.04305126783455
5729,4,89,No,7,4,356,93,623,356,28,96,0.044444444444444446,0.07777777777777778,1.6094379124341003,4.499809670330265
7830,4,79,Yes,8,1,316,83,632,79,32,87,0.05,0.1,1.6094379124341003,4.382026634673881
1039,4,86,Yes,7,6,344,90,602,516,28,93,0.04597701149425287,0.08045977011494253,1.6094379124341003,4.465908118654584
1195,6,66,Yes,8,8,396,72,528,528,48,74,0.08955223880597014,0.11940298507462686,1.9459101490553132,4.204692619390966
4475,3,79,No,8,4,237,82,632,316,24,87,0.0375,0.1,1.3862943611198906,4.382026634673881
9875,6,49,No,5,5,294,55,245,245,30,54,0.12,0.1,1.9459101490553132,3.912023005428146
2123,2,63,Yes,7,1,126,65,441,63,14,70,0.03125,0.109375,1.0986122886681098,4.1588830833596715
4983,5,95,Yes,4,4,475,100,380,380,20,99,0.052083333333333336,0.041666666666666664,1.791759469228055,4.564348191467836
8974,5,62,No,4,5,310,67,248,310,20,66,0.07936507936507936,0.06349206349206349,1.791759469228055,4.143134726391533
5701,1,44,No,4,8,44,45,176,352,4,48,0.022222222222222223,0.08888888888888889,0.6931471805599453,3.8066624897703196
935,7,99,No,7,3,693,106,693,297,49,106,0.07,0.07,2.0794415416798357,4.605170185988092
6102,9,77,No,4,4,693,86,308,308,36,81,0.11538461538461539,0.05128205128205128,2.302585092994046,4.356708826689592
4690,1,51,No,4,8,51,52,204,408,4,55,0.019230769230769232,0.07692307692307693,0.6931471805599453,3.9512437185814275
395,2,57,Yes,4,6,114,59,228,342,8,61,0.034482758620689655,0.06896551724137931,1.0986122886681098,4.060443010546419
4686,5,48,No,6,4,240,53,288,192,30,54,0.10204081632653061,0.12244897959183673,1.791759469228055,3.8918202981106265
8777,6,68,No,5,5,408,74,340,340,30,73,0.08695652173913043,0.07246376811594203,1.9459101490553132,4.23410650459726
9166,8,53,Yes,8,5,424,61,424,265,64,61,0.14814814814814814,0.14814814814814814,2.1972245773362196,3.9889840465642745
5981,6,99,Yes,8,6,594,105,792,594,48,107,0.06,0.08,1.9459101490553132,4.605170185988092
9943,7,99,No,8,1,693,106,792,99,56,107,0.07,0.08,2.0794415416798357,4.605170185988092
2192,7,55,Yes,7,1,385,62,385,55,49,62,0.125,0.125,2.0794415416798357,4.02535169073515
1298,5,78,No,8,1,390,83,624,78,40,86,0.06329113924050633,0.10126582278481013,1.791759469228055,4.3694478524670215
5045,5,48,No,8,5,240,53,384,240,40,56,0.10204081632653061,0.16326530612244897,1.791759469228055,3.8918202981106265
1163,7,65,Yes,4,4,455,72,260,260,28,69,0.10606060606060606,0.06060606060606061,2.0794415416798357,4.189654742026425
4255,7,93,Yes,6,3,651,100,558,279,42,99,0.07446808510638298,0.06382978723404255,2.0794415416798357,4.543294782270004
6373,1,62,Yes,8,9,62,63,496,558,8,70,0.015873015873015872,0.12698412698412698,0.6931471805599453,4.143134726391533
1528,2,48,No,7,1,96,50,336,48,14,55,0.04081632653061224,0.14285714285714285,1.0986122886681098,3.8918202981106265
4343,1,66,Yes,5,6,66,67,330,396,5,71,0.014925373134328358,0.07462686567164178,0.6931471805599453,4.204692619390966
2031,6,58,No,6,5,348,64,348,290,36,64,0.1016949152542373,0.1016949152542373,1.9459101490553132,4.07753744390572
3061,6,42,No,4,6,252,48,168,252,24,46,0.13953488372093023,0.09302325581395349,1.9459101490553132,3.7612001156935624
59,4,98,No,6,0,392,102,588,0,24,104,0.04040404040404041,0.06060606060606061,1.6094379124341003,4.59511985013459
2406,6,90,Yes,9,1,540,96,810,90,54,99,0.06593406593406594,0.0989010989010989,1.9459101490553132,4.51085950651685
5007,7,89,Yes,5,7,623,96,445,623,35,94,0.07777777777777778,0.05555555555555555,2.0794415416798357,4.499809670330265
6158,9,72,No,9,7,648,81,648,504,81,81,0.1232876712328767,0.1232876712328767,2.302585092994046,4.290459441148391
7376,6,42,No,7,8,252,48,294,336,42,49,0.13953488372093023,0.16279069767441862,1.9459101490553132,3.7612001156935624
4507,5,41,Yes,8,6,205,46,328,246,40,49,0.11904761904761904,0.19047619047619047,1.791759469228055,3.7376696182833684
5215,8,70,Yes,9,1,560,78,630,70,72,79,0.11267605633802817,0.1267605633802817,2.1972245773362196,4.2626798770413155
6030,2,96,Yes,6,7,192,98,576,672,12,102,0.020618556701030927,0.061855670103092786,1.0986122886681098,4.574710978503383
1781,5,77,No,7,6,385,82,539,462,35,84,0.0641025641025641,0.08974358974358974,1.791759469228055,4.356708826689592
5448,1,87,No,8,9,87,88,696,783,8,95,0.011363636363636364,0.09090909090909091,0.6931471805599453,4.477336814478207
4607,9,65,Yes,7,2,585,74,455,130,63,72,0.13636363636363635,0.10606060606060606,2.302585092994046,4.189654742026425
6915,5,82,Yes,4,7,410,87,328,574,20,86,0.060240963855421686,0.04819277108433735,1.791759469228055,4.418840607796598
677,5,89,No,5,6,445,94,445,534,25,94,0.05555555555555555,0.05555555555555555,1.791759469228055,4.499809670330265
3583,3,55,Yes,5,2,165,58,275,110,15,60,0.05357142857142857,0.08928571428571429,1.3862943611198906,4.02535169073515
3654,5,51,Yes,8,8,255,56,408,408,40,59,0.09615384615384616,0.15384615384615385,1.791759469228055,3.9512437185814275
7921,4,62,No,8,8,248,66,496,496,32,70,0.06349206349206349,0.12698412698412698,1.6094379124341003,4.143134726391533
9500,5,70,Yes,8,2,350,75,560,140,40,78,0.07042253521126761,0.11267605633802817,1.791759469228055,4.2626798770413155
2733,8,83,Yes,8,1,664,91,664,83,64,91,0.09523809523809523,0.09523809523809523,2.1972245773362196,4.430816798843313
4788,4,67,Yes,6,1,268,71,402,67,24,73,0.058823529411764705,0.08823529411764706,1.6094379124341003,4.219507705176107
2755,4,74,No,7,4,296,78,518,296,28,81,0.05333333333333334,0.09333333333333334,1.6094379124341003,4.31748811353631
2338,1,40,No,9,6,40,41,360,240,9,49,0.024390243902439025,0.21951219512195122,0.6931471805599453,3.713572066704308
3644,4,88,No,7,0,352,92,616,0,28,95,0.0449438202247191,0.07865168539325842,1.6094379124341003,4.48863636973214
7738,9,64,No,6,7,576,73,384,448,54,70,0.13846153846153847,0.09230769230769231,2.302585092994046,4.174387269895637
5517,8,53,No,5,2,424,61,265,106,40,58,0.14814814814814814,0.09259259259259259,2.1972245773362196,3.9889840465642745
5247,3,73,Yes,9,6,219,76,657,438,27,82,0.04054054054054054,0.12162162162162163,1.3862943611198906,4.30406509320417
867,2,46,No,5,0,92,48,230,0,10,51,0.0425531914893617,0.10638297872340426,1.0986122886681098,3.8501476017100584
4448,3,54,Yes,4,4,162,57,216,216,12,58,0.05454545454545454,0.07272727272727272,1.3862943611198906,4.007333185232471
5072,2,72,Yes,9,8,144,74,648,576,18,81,0.0273972602739726,0.1232876712328767,1.0986122886681098,4.290459441148391
4882,4,75,No,7,8,300,79,525,600,28,82,0.05263157894736842,0.09210526315789473,1.6094379124341003,4.330733340286331
9511,5,52,No,8,1,260,57,416,52,40,60,0.09433962264150944,0.1509433962264151,1.791759469228055,3.970291913552122
3003,5,40,Yes,8,9,200,45,320,360,40,48,0.12195121951219512,0.1951219512195122,1.791759469228055,3.713572066704308
2226,1,42,Yes,9,7,42,43,378,294,9,51,0.023255813953488372,0.20930232558139536,0.6931471805599453,3.7612001156935624
9057,9,82,Yes,4,4,738,91,328,328,36,86,0.10843373493975904,0.04819277108433735,2.302585092994046,4.418840607796598
4827,4,96,Yes,9,2,384,100,864,192,36,105,0.041237113402061855,0.09278350515463918,1.6094379124341003,4.574710978503383
7622,5,98,No,8,5,490,103,784,490,40,106,0.050505050505050504,0.08080808080808081,1.791759469228055,4.59511985013459
9690,3,52,No,5,7,156,55,260,364,15,57,0.05660377358490566,0.09433962264150944,1.3862943611198906,3.970291913552122
5501,2,45,No,4,7,90,47,180,315,8,49,0.043478260869565216,0.08695652173913043,1.0986122886681098,3.828641396489095
9701,1,87,No,7,2,87,88,609,174,7,94,0.011363636363636364,0.07954545454545454,0.6931471805599453,4.477336814478207
8479,9,96,Yes,8,9,864,105,768,864,72,104,0.09278350515463918,0.08247422680412371,2.302585092994046,4.574710978503383
5503,9,96,No,5,1,864,105,480,96,45,101,0.09278350515463918,0.05154639175257732,2.302585092994046,4.574710978503383
1211,8,40,Yes,6,7,320,48,240,280,48,46,0.1951219512195122,0.14634146341463414,2.1972245773362196,3.713572066704308
9084,1,95,No,6,1,95,96,570,95,6,101,0.010416666666666666,0.0625,0.6931471805599453,4.564348191467836
2289,4,94,Yes,8,3,376,98,752,282,32,102,0.042105263157894736,0.08421052631578947,1.6094379124341003,4.553876891600541
2184,8,53,No,7,1,424,61,371,53,56,60,0.14814814814814814,0.12962962962962962,2.1972245773362196,3.9889840465642745
2863,1,97,Yes,4,5,97,98,388,485,4,101,0.01020408163265306,0.04081632653061224,0.6931471805599453,4.584967478670572
6862,3,67,Yes,5,1,201,70,335,67,15,72,0.04411764705882353,0.07352941176470588,1.3862943611198906,4.219507705176107
2363,5,87,Yes,6,1,435,92,522,87,30,93,0.056818181818181816,0.06818181818181818,1.791759469228055,4.477336814478207
8464,9,85,No,6,1,765,94,510,85,54,91,0.10465116279069768,0.06976744186046512,2.302585092994046,4.454347296253507
6333,8,65,Yes,4,7,520,73,260,455,32,69,0.12121212121212122,0.06060606060606061,2.1972245773362196,4.189654742026425
4065,2,95,Yes,9,6,190,97,855,570,18,104,0.020833333333333332,0.09375,1.0986122886681098,4.564348191467836
9547,1,57,No,8,8,57,58,456,456,8,65,0.017241379310344827,0.13793103448275862,0.6931471805599453,4.060443010546419
618,9,66,No,9,6,594,75,594,396,81,75,0.13432835820895522,0.13432835820895522,2.302585092994046,4.204692619390966
3282,8,41,No,9,3,328,49,369,123,72,50,0.19047619047619047,0.21428571428571427,2.1972245773362196,3.7376696182833684
5227,4,61,No,7,7,244,65,427,427,28,68,0.06451612903225806,0.11290322580645161,1.6094379124341003,4.127134385045092
3398,1,98,Yes,5,8,98,99,490,784,5,103,0.010101010101010102,0.050505050505050504,0.6931471805599453,4.59511985013459
3066,9,58,Yes,9,4,522,67,522,232,81,67,0.15254237288135594,0.15254237288135594,2.302585092994046,4.07753744390572
767,9,41,No,9,8,369,50,369,328,81,50,0.21428571428571427,0.21428571428571427,2.302585092994046,3.7376696182833684
7079,6,97,No,7,0,582,103,679,0,42,104,0.061224489795918366,0.07142857142857142,1.9459101490553132,4.584967478670572
5280,6,73,Yes,4,8,438,79,292,584,24,77,0.08108108108108109,0.05405405405405406,1.9459101490553132,4.30406509320417
4150,9,40,No,8,2,360,49,320,80,72,48,0.21951219512195122,0.1951219512195122,2.302585092994046,3.713572066704308
1145,1,48,No,4,9,48,49,192,432,4,52,0.02040816326530612,0.08163265306122448,0.6931471805599453,3.8918202981106265
4249,7,58,No,6,1,406,65,348,58,42,64,0.11864406779661017,0.1016949152542373,2.0794415416798357,4.07753744390572
4111,4,42,No,8,9,168,46,336,378,32,50,0.09302325581395349,0.18604651162790697,1.6094379124341003,3.7612001156935624
463,5,42,No,6,2,210,47,252,84,30,48,0.11627906976744186,0.13953488372093023,1.791759469228055,3.7612001156935624
2933,8,67,No,5,4,536,75,335,268,40,72,0.11764705882352941,0.07352941176470588,2.1972245773362196,4.219507705176107
4624,2,49,No,6,4,98,51,294,196,12,55,0.04,0.12,1.0986122886681098,3.912023005428146
3814,5,98,Yes,8,4,490,103,784,392,40,106,0.050505050505050504,0.08080808080808081,1.791759469228055,4.59511985013459
6309,5,75,Yes,9,6,375,80,675,450,45,84,0.06578947368421052,0.11842105263157894,1.791759469228055,4.330733340286331
4342,6,49,Yes,8,4,294,55,392,196,48,57,0.12,0.16,1.9459101490553132,3.912023005428146
5301,7,40,No,6,3,280,47,240,120,42,46,0.17073170731707318,0.14634146341463414,2.0794415416798357,3.713572066704308
6805,2,99,No,6,2,198,101,594,198,12,105,0.02,0.06,1.0986122886681098,4.605170185988092
3283,5,87,No,4,6,435,92,348,522,20,91,0.056818181818181816,0.045454545454545456,1.791759469228055,4.477336814478207
2575,7,70,No,8,9,490,77,560,630,56,78,0.09859154929577464,0.11267605633802817,2.0794415416798357,4.2626798770413155
7962,8,52,No,5,0,416,60,260,0,40,57,0.1509433962264151,0.09433962264150944,2.1972245773362196,3.970291913552122
7880,1,86,No,5,4,86,87,430,344,5,91,0.011494252873563218,0.05747126436781609,0.6931471805599453,4.465908118654584
829,8,67,No,6,3,536,75,402,201,48,73,0.11764705882352941,0.08823529411764706,2.1972245773362196,4.219507705176107
6487,2,55,Yes,8,7,110,57,440,385,16,63,0.03571428571428571,0.14285714285714285,1.0986122886681098,4.02535169073515
7600,2,68,Yes,4,7,136,70,272,476,8,72,0.028985507246376812,0.057971014492753624,1.0986122886681098,4.23410650459726
2541,9,80,No,9,7,720,89,720,560,81,89,0.1111111111111111,0.1111111111111111,2.302585092994046,4.394449154672439
5747,3,94,No,8,4,282,97,752,376,24,102,0.031578947368421054,0.08421052631578947,1.3862943611198906,4.553876891600541
8527,9,43,No,7,9,387,52,301,387,63,50,0.20454545454545456,0.1590909090909091,2.302585092994046,3.784189633918261
9567,8,85,No,9,7,680,93,765,595,72,94,0.09302325581395349,0.10465116279069768,2.1972245773362196,4.454347296253507
3743,9,50,No,9,3,450,59,450,150,81,59,0.17647058823529413,0.17647058823529413,2.302585092994046,3.9318256327243257
7499,3,77,No,8,6,231,80,616,462,24,85,0.038461538461538464,0.10256410256410256,1.3862943611198906,4.356708826689592
3525,9,92,Yes,4,2,828,101,368,184,36,96,0.0967741935483871,0.043010752688172046,2.302585092994046,4.532599493153256
21,1,99,Yes,4,3,99,100,396,297,4,103,0.01,0.04,0.6931471805599453,4.605170185988092
1916,6,95,Yes,5,9,570,101,475,855,30,100,0.0625,0.052083333333333336,1.9459101490553132,4.564348191467836
6572,8,76,Yes,7,8,608,84,532,608,56,83,0.1038961038961039,0.09090909090909091,2.1972245773362196,4.343805421853684
9019,2,85,No,7,7,170,87,595,595,14,92,0.023255813953488372,0.08139534883720931,1.0986122886681098,4.454347296253507
2013,4,56,Yes,5,8,224,60,280,448,20,61,0.07017543859649122,0.08771929824561403,1.6094379124341003,4.04305126783455
5406,8,81,No,6,2,648,89,486,162,48,87,0.0975609756097561,0.07317073170731707,2.1972245773362196,4.406719247264253
1296,6,96,No,8,9,576,102,768,864,48,104,0.061855670103092786,0.08247422680412371,1.9459101490553132,4.574710978503383
3746,8,52,No,8,8,416,60,416,416,64,60,0.1509433962264151,0.1509433962264151,2.1972245773362196,3.970291913552122
592,5,60,No,9,0,300,65,540,0,45,69,0.08196721311475409,0.14754098360655737,1.791759469228055,4.110873864173311
1407,5,60,Yes,5,8,300,65,300,480,25,65,0.08196721311475409,0.08196721311475409,1.791759469228055,4.110873864173311
222,8,67,Yes,9,5,536,75,603,335,72,76,0.11764705882352941,0.1323529411764706,2.1972245773362196,4.219507705176107
5618,6,51,Yes,9,3,306,57,459,153,54,60,0.11538461538461539,0.17307692307692307,1.9459101490553132,3.9512437185814275
6249,3,40,No,4,1,120,43,160,40,12,44,0.07317073170731707,0.0975609756097561,1.3862943611198906,3.713572066704308
4419,4,83,No,4,1,332,87,332,83,16,87,0.047619047619047616,0.047619047619047616,1.6094379124341003,4.430816798843313
859,6,91,No,4,2,546,97,364,182,24,95,0.06521739130434782,0.043478260869565216,1.9459101490553132,4.5217885770490405
1784,9,41,No,9,5,369,50,369,205,81,50,0.21428571428571427,0.21428571428571427,2.302585092994046,3.7376696182833684
7260,4,93,No,8,5,372,97,744,465,32,101,0.0425531914893617,0.0851063829787234,1.6094379124341003,4.543294782270004
6857,5,92,Yes,6,5,460,97,552,460,30,98,0.053763440860215055,0.06451612903225806,1.791759469228055,4.532599493153256
1955,9,77,Yes,4,2,693,86,308,154,36,81,0.11538461538461539,0.05128205128205128,2.302585092994046,4.356708826689592
1747,6,86,No,7,0,516,92,602,0,42,93,0.06896551724137931,0.08045977011494253,1.9459101490553132,4.465908118654584
3133,5,84,No,4,7,420,89,336,588,20,88,0.058823529411764705,0.047058823529411764,1.791759469228055,4.442651256490317
8037,9,66,No,4,2,594,75,264,132,36,70,0.13432835820895522,0.05970149253731343,2.302585092994046,4.204692619390966
8851,4,68,Yes,5,6,272,72,340,408,20,73,0.057971014492753624,0.07246376811594203,1.6094379124341003,4.23410650459726
995,7,60,Yes,9,3,420,67,540,180,63,69,0.11475409836065574,0.14754098360655737,2.0794415416798357,4.110873864173311
6109,7,80,No,8,0,560,87,640,0,56,88,0.08641975308641975,0.09876543209876543,2.0794415416798357,4.394449154672439
731,5,91,Yes,6,9,455,96,546,819,30,97,0.05434782608695652,0.06521739130434782,1.791759469228055,4.5217885770490405
6975,7,81,No,6,1,567,88,486,81,42,87,0.08536585365853659,0.07317073170731707,2.0794415416798357,4.406719247264253
6274,4,91,Yes,4,3,364,95,364,273,16,95,0.043478260869565216,0.043478260869565216,1.6094379124341003,4.5217885770490405
6752,7,75,No,6,6,525,82,450,450,42,81,0.09210526315789473,0.07894736842105263,2.0794415416798357,4.330733340286331
3510,9,81,Yes,7,6,729,90,567,486,63,88,0.10975609756097561,0.08536585365853659,2.302585092994046,4.406719247264253
3534,3,88,No,8,8,264,91,704,704,24,96,0.033707865168539325,0.0898876404494382,1.3862943611198906,4.48863636973214
2514,8,82,Yes,4,8,656,90,328,656,32,86,0.0963855421686747,0.04819277108433735,2.1972245773362196,4.418840607796598
5437,4,47,Yes,4,6,188,51,188,282,16,51,0.08333333333333333,0.08333333333333333,1.6094379124341003,3.871201010907891
3626,8,46,No,5,7,368,54,230,322,40,51,0.1702127659574468,0.10638297872340426,2.1972245773362196,3.8501476017100584
466,4,54,Yes,8,4,216,58,432,216,32,62,0.07272727272727272,0.14545454545454545,1.6094379124341003,4.007333185232471
6756,4,83,No,5,5,332,87,415,415,20,88,0.047619047619047616,0.05952380952380952,1.6094379124341003,4.430816798843313
6760,4,60,Yes,9,9,240,64,540,540,36,69,0.06557377049180328,0.14754098360655737,1.6094379124341003,4.110873864173311
7992,7,61,No,7,9,427,68,427,549,49,68,0.11290322580645161,0.11290322580645161,2.0794415416798357,4.127134385045092
158,1,52,No,5,2,52,53,260,104,5,57,0.018867924528301886,0.09433962264150944,0.6931471805599453,3.970291913552122
3961,8,40,Yes,8,2,320,48,320,80,64,48,0.1951219512195122,0.1951219512195122,2.1972245773362196,3.713572066704308
8833,7,93,Yes,6,1,651,100,558,93,42,99,0.07446808510638298,0.06382978723404255,2.0794415416798357,4.543294782270004
5471,3,81,No,6,6,243,84,486,486,18,87,0.036585365853658534,0.07317073170731707,1.3862943611198906,4.406719247264253
186,3,87,No,9,1,261,90,783,87,27,96,0.03409090909090909,0.10227272727272728,1.3862943611198906,4.477336814478207
1003,8,60,Yes,6,2,480,68,360,120,48,66,0.13114754098360656,0.09836065573770492,2.1972245773362196,4.110873864173311
9509,6,53,No,9,8,318,59,477,424,54,62,0.1111111111111111,0.16666666666666666,1.9459101490553132,3.9889840465642745
5624,5,87,No,6,2,435,92,522,174,30,93,0.056818181818181816,0.06818181818181818,1.791759469228055,4.477336814478207
401,1,44,Yes,7,3,44,45,308,132,7,51,0.022222222222222223,0.15555555555555556,0.6931471805599453,3.8066624897703196
6241,5,40,Yes,5,8,200,45,200,320,25,45,0.12195121951219512,0.12195121951219512,1.791759469228055,3.713572066704308
8941,1,63,No,9,1,63,64,567,63,9,72,0.015625,0.140625,0.6931471805599453,4.1588830833596715
9933,7,82,No,7,1,574,89,574,82,49,89,0.08433734939759036,0.08433734939759036,2.0794415416798357,4.418840607796598
7343,8,67,Yes,5,8,536,75,335,536,40,72,0.11764705882352941,0.07352941176470588,2.1972245773362196,4.219507705176107
9833,5,90,Yes,4,8,450,95,360,720,20,94,0.054945054945054944,0.04395604395604396,1.791759469228055,4.51085950651685
8467,5,66,Yes,5,4,330,71,330,264,25,71,0.07462686567164178,0.07462686567164178,1.791759469228055,4.204692619390966
8757,3,62,Yes,4,8,186,65,248,496,12,66,0.047619047619047616,0.06349206349206349,1.3862943611198906,4.143134726391533
7959,3,41,No,8,5,123,44,328,205,24,49,0.07142857142857142,0.19047619047619047,1.3862943611198906,3.7376696182833684
1251,9,56,No,5,2,504,65,280,112,45,61,0.15789473684210525,0.08771929824561403,2.302585092994046,4.04305126783455
3144,5,69,No,9,7,345,74,621,483,45,78,0.07142857142857142,0.12857142857142856,1.791759469228055,4.248495242049359
7431,9,64,Yes,6,3,576,73,384,192,54,70,0.13846153846153847,0.09230769230769231,2.302585092994046,4.174387269895637
60,8,48,No,6,0,384,56,288,0,48,54,0.16326530612244897,0.12244897959183673,2.1972245773362196,3.8918202981106265
7856,4,68,Yes,4,3,272,72,272,204,16,72,0.057971014492753624,0.057971014492753624,1.6094379124341003,4.23410650459726
1114,8,52,No,5,6,416,60,260,312,40,57,0.1509433962264151,0.09433962264150944,2.1972245773362196,3.970291913552122
3058,5,48,Yes,5,3,240,53,240,144,25,53,0.10204081632653061,0.10204081632653061,1.791759469228055,3.8918202981106265
9570,5,44,No,6,0,220,49,264,0,30,50,0.1111111111111111,0.13333333333333333,1.791759469228055,3.8066624897703196
1329,7,42,Yes,5,4,294,49,210,168,35,47,0.16279069767441862,0.11627906976744186,2.0794415416798357,3.7612001156935624
4996,7,53,Yes,5,7,371,60,265,371,35,58,0.12962962962962962,0.09259259259259259,2.0794415416798357,3.9889840465642745
6683,4,95,Yes,8,3,380,99,760,285,32,103,0.041666666666666664,0.08333333333333333,1.6094379124341003,4.564348191467836
2073,2,80,No,4,9,160,82,320,720,8,84,0.024691358024691357,0.04938271604938271,1.0986122886681098,4.394449154672439
4794,6,91,No,4,5,546,97,364,455,24,95,0.06521739130434782,0.043478260869565216,1.9459101490553132,4.5217885770490405
6830,9,91,Yes,5,9,819,100,455,819,45,96,0.09782608695652174,0.05434782608695652,2.302585092994046,4.5217885770490405
9630,3,61,No,9,7,183,64,549,427,27,70,0.04838709677419355,0.14516129032258066,1.3862943611198906,4.127134385045092
8219,2,43,Yes,8,1,86,45,344,43,16,51,0.045454545454545456,0.18181818181818182,1.0986122886681098,3.784189633918261
7568,1,46,No,4,7,46,47,184,322,4,50,0.02127659574468085,0.0851063829787234,0.6931471805599453,3.8501476017100584
5923,5,62,No,5,9,310,67,310,558,25,67,0.07936507936507936,0.07936507936507936,1.791759469228055,4.143134726391533
1551,6,97,Yes,9,2,582,103,873,194,54,106,0.061224489795918366,0.09183673469387756,1.9459101490553132,4.584967478670572
1010,8,88,No,7,4,704,96,616,352,56,95,0.0898876404494382,0.07865168539325842,2.1972245773362196,4.48863636973214
3756,7,49,No,7,8,343,56,343,392,49,56,0.14,0.14,2.0794415416798357,3.912023005428146
8682,7,56,Yes,9,3,392,63,504,168,63,65,0.12280701754385964,0.15789473684210525,2.0794415416798357,4.04305126783455
9343,7,80,Yes,9,9,560,87,720,720,63,89,0.08641975308641975,0.1111111111111111,2.0794415416798357,4.394449154672439
8010,8,91,No,8,4,728,99,728,364,64,99,0.08695652173913043,0.08695652173913043,2.1972245773362196,4.5217885770490405
3861,9,58,No,8,2,522,67,464,116,72,66,0.15254237288135594,0.13559322033898305,2.302585092994046,4.07753744390572
3149,1,74,Yes,7,4,74,75,518,296,7,81,0.013333333333333334,0.09333333333333334,0.6931471805599453,4.31748811353631
2520,3,72,No,7,1,216,75,504,72,21,79,0.0410958904109589,0.0958904109589041,1.3862943611198906,4.290459441148391
3128,7,47,Yes,5,8,329,54,235,376,35,52,0.14583333333333334,0.10416666666666667,2.0794415416798357,3.871201010907891
9085,2,81,Yes,9,2,162,83,729,162,18,90,0.024390243902439025,0.10975609756097561,1.0986122886681098,4.406719247264253
5317,2,43,Yes,8,6,86,45,344,258,16,51,0.045454545454545456,0.18181818181818182,1.0986122886681098,3.784189633918261
1196,9,83,Yes,6,3,747,92,498,249,54,89,0.10714285714285714,0.07142857142857142,2.302585092994046,4.430816798843313
9051,3,91,No,5,7,273,94,455,637,15,96,0.03260869565217391,0.05434782608695652,1.3862943611198906,4.5217885770490405
880,3,93,No,5,1,279,96,465,93,15,98,0.031914893617021274,0.05319148936170213,1.3862943611198906,4.543294782270004
6990,6,71,No,9,8,426,77,639,568,54,80,0.08333333333333333,0.125,1.9459101490553132,4.276666119016055
2488,9,48,Yes,6,2,432,57,288,96,54,54,0.1836734693877551,0.12244897959183673,2.302585092994046,3.8918202981106265
2841,6,44,Yes,9,9,264,50,396,396,54,53,0.13333333333333333,0.2,1.9459101490553132,3.8066624897703196
4330,6,67,No,8,3,402,73,536,201,48,75,0.08823529411764706,0.11764705882352941,1.9459101490553132,4.219507705176107
2931,8,56,Yes,9,9,448,64,504,504,72,65,0.14035087719298245,0.15789473684210525,2.1972245773362196,4.04305126783455
6425,7,72,No,8,3,504,79,576,216,56,80,0.0958904109589041,0.1095890410958904,2.0794415416798357,4.290459441148391
2486,5,64,No,6,5,320,69,384,320,30,70,0.07692307692307693,0.09230769230769231,1.791759469228055,4.174387269895637
5748,3,47,No,8,7,141,50,376,329,24,55,0.0625,0.16666666666666666,1.3862943611198906,3.871201010907891
884,5,62,No,7,8,310,67,434,496,35,69,0.07936507936507936,0.1111111111111111,1.791759469228055,4.143134726391533
4915,7,78,No,9,3,546,85,702,234,63,87,0.08860759493670886,0.11392405063291139,2.0794415416798357,4.3694478524670215
6211,9,68,No,5,2,612,77,340,136,45,73,0.13043478260869565,0.07246376811594203,2.302585092994046,4.23410650459726
9579,5,88,No,4,4,440,93,352,352,20,92,0.056179775280898875,0.0449438202247191,1.791759469228055,4.48863636973214
212,1,57,No,9,2,57,58,513,114,9,66,0.017241379310344827,0.15517241379310345,0.6931471805599453,4.060443010546419
2276,3,96,No,9,6,288,99,864,576,27,105,0.030927835051546393,0.09278350515463918,1.3862943611198906,4.574710978503383
2329,9,51,Yes,5,6,459,60,255,306,45,56,0.17307692307692307,0.09615384615384616,2.302585092994046,3.9512437185814275
4951,2,76,No,4,5,152,78,304,380,8,80,0.025974025974025976,0.05194805194805195,1.0986122886681098,4.343805421853684
3320,9,79,Yes,8,9,711,88,632,711,72,87,0.1125,0.1,2.302585092994046,4.382026634673881
9835,1,57,Yes,6,1,57,58,342,57,6,63,0.017241379310344827,0.10344827586206896,0.6931471805599453,4.060443010546419
4608,2,67,Yes,7,3,134,69,469,201,14,74,0.029411764705882353,0.10294117647058823,1.0986122886681098,4.219507705176107
1439,8,88,Yes,6,1,704,96,528,88,48,94,0.0898876404494382,0.06741573033707865,2.1972245773362196,4.48863636973214
468,4,87,Yes,5,1,348,91,435,87,20,92,0.045454545454545456,0.056818181818181816,1.6094379124341003,4.477336814478207
5467,7,62,No,9,1,434,69,558,62,63,71,0.1111111111111111,0.14285714285714285,2.0794415416798357,4.143134726391533
3330,4,57,No,6,1,228,61,342,57,24,63,0.06896551724137931,0.10344827586206896,1.6094379124341003,4.060443010546419
5829,5,53,No,7,0,265,58,371,0,35,60,0.09259259259259259,0.12962962962962962,1.791759469228055,3.9889840465642745
8608,4,84,Yes,6,3,336,88,504,252,24,90,0.047058823529411764,0.07058823529411765,1.6094379124341003,4.442651256490317
697,2,72,No,9,1,144,74,648,72,18,81,0.0273972602739726,0.1232876712328767,1.0986122886681098,4.290459441148391
7268,1,52,No,8,3,52,53,416,156,8,60,0.018867924528301886,0.1509433962264151,0.6931471805599453,3.970291913552122
9145,9,54,Yes,7,3,486,63,378,162,63,61,0.16363636363636364,0.12727272727272726,2.302585092994046,4.007333185232471
8181,1,53,No,5,9,53,54,265,477,5,58,0.018518518518518517,0.09259259259259259,0.6931471805599453,3.9889840465642745
9939,6,64,Yes,4,9,384,70,256,576,24,68,0.09230769230769231,0.06153846153846154,1.9459101490553132,4.174387269895637
1315,9,56,No,4,3,504,65,224,168,36,60,0.15789473684210525,0.07017543859649122,2.302585092994046,4.04305126783455
2302,5,91,No,9,4,455,96,819,364,45,100,0.05434782608695652,0.09782608695652174,1.791759469228055,4.5217885770490405
2040,7,87,No,7,6,609,94,609,522,49,94,0.07954545454545454,0.07954545454545454,2.0794415416798357,4.477336814478207
7109,8,93,No,5,8,744,101,465,744,40,98,0.0851063829787234,0.05319148936170213,2.1972245773362196,4.543294782270004
3667,9,95,No,4,2,855,104,380,190,36,99,0.09375,0.041666666666666664,2.302585092994046,4.564348191467836
915,7,68,No,9,6,476,75,612,408,63,77,0.10144927536231885,0.13043478260869565,2.0794415416798357,4.23410650459726
13,3,47,No,9,2,141,50,423,94,27,56,0.0625,0.1875,1.3862943611198906,3.871201010907891
8584,2,42,No,6,1,84,44,252,42,12,48,0.046511627906976744,0.13953488372093023,1.0986122886681098,3.7612001156935624
6428,7,67,Yes,7,6,469,74,469,402,49,74,0.10294117647058823,0.10294117647058823,2.0794415416798357,4.219507705176107
1537,2,92,Yes,6,6,184,94,552,552,12,98,0.021505376344086023,0.06451612903225806,1.0986122886681098,4.532599493153256
737,5,44,No,8,0,220,49,352,0,40,52,0.1111111111111111,0.17777777777777778,1.791759469228055,3.8066624897703196
8202,1,94,Yes,9,3,94,95,846,282,9,103,0.010526315789473684,0.09473684210526316,0.6931471805599453,4.553876891600541
8653,2,82,Yes,7,2,164,84,574,164,14,89,0.024096385542168676,0.08433734939759036,1.0986122886681098,4.418840607796598
454,1,46,Yes,4,3,46,47,184,138,4,50,0.02127659574468085,0.0851063829787234,0.6931471805599453,3.8501476017100584
4346,3,78,No,8,2,234,81,624,156,24,86,0.0379746835443038,0.10126582278481013,1.3862943611198906,4.3694478524670215
928,5,73,No,7,8,365,78,511,584,35,80,0.06756756756756757,0.0945945945945946,1.791759469228055,4.30406509320417
6292,3,91,Yes,6,6,273,94,546,546,18,97,0.03260869565217391,0.06521739130434782,1.3862943611198906,4.5217885770490405
8282,1,73,Yes,7,3,73,74,511,219,7,80,0.013513513513513514,0.0945945945945946,0.6931471805599453,4.30406509320417
8723,1,66,Yes,8,0,66,67,528,0,8,74,0.014925373134328358,0.11940298507462686,0.6931471805599453,4.204692619390966
6474,5,60,Yes,5,9,300,65,300,540,25,65,0.08196721311475409,0.08196721311475409,1.791759469228055,4.110873864173311
38,9,72,No,8,2,648,81,576,144,72,80,0.1232876712328767,0.1095890410958904,2.302585092994046,4.290459441148391
5771,8,87,No,5,3,696,95,435,261,40,92,0.09090909090909091,0.056818181818181816,2.1972245773362196,4.477336814478207
2555,1,97,Yes,4,5,97,98,388,485,4,101,0.01020408163265306,0.04081632653061224,0.6931471805599453,4.584967478670572
7633,7,91,No,9,3,637,98,819,273,63,100,0.07608695652173914,0.09782608695652174,2.0794415416798357,4.5217885770490405
9999,9,97,Yes,7,0,873,106,679,0,63,104,0.09183673469387756,0.07142857142857142,2.302585092994046,4.584967478670572
6621,1,77,Yes,7,4,77,78,539,308,7,84,0.01282051282051282,0.08974358974358974,0.6931471805599453,4.356708826689592
941,8,59,No,6,6,472,67,354,354,48,65,0.13333333333333333,0.1,2.1972245773362196,4.0943445622221
7399,4,60,No,4,0,240,64,240,0,16,64,0.06557377049180328,0.06557377049180328,1.6094379124341003,4.110873864173311
6129,2,58,No,8,1,116,60,464,58,16,66,0.03389830508474576,0.13559322033898305,1.0986122886681098,4.07753744390572
9830,5,95,Yes,5,1,475,100,475,95,25,100,0.052083333333333336,0.052083333333333336,1.791759469228055,4.564348191467836
2681,2,53,Yes,5,9,106,55,265,477,10,58,0.037037037037037035,0.09259259259259259,1.0986122886681098,3.9889840465642745
4355,4,50,Yes,4,9,200,54,200,450,16,54,0.0784313725490196,0.0784313725490196,1.6094379124341003,3.9318256327243257
3059,8,40,No,4,3,320,48,160,120,32,44,0.1951219512195122,0.0975609756097561,2.1972245773362196,3.713572066704308
7881,7,56,Yes,7,8,392,63,392,448,49,63,0.12280701754385964,0.12280701754385964,2.0794415416798357,4.04305126783455
739,1,42,Yes,8,1,42,43,336,42,8,50,0.023255813953488372,0.18604651162790697,0.6931471805599453,3.7612001156935624
539,7,74,No,9,9,518,81,666,666,63,83,0.09333333333333334,0.12,2.0794415416798357,4.31748811353631
3326,7,73,Yes,9,5,511,80,657,365,63,82,0.0945945945945946,0.12162162162162163,2.0794415416798357,4.30406509320417
4240,3,81,No,8,3,243,84,648,243,24,89,0.036585365853658534,0.0975609756097561,1.3862943611198906,4.406719247264253
1401,5,84,Yes,6,8,420,89,504,672,30,90,0.058823529411764705,0.07058823529411765,1.791759469228055,4.442651256490317
4047,2,65,No,4,0,130,67,260,0,8,69,0.030303030303030304,0.06060606060606061,1.0986122886681098,4.189654742026425
5138,9,70,Yes,4,6,630,79,280,420,36,74,0.1267605633802817,0.056338028169014086,2.302585092994046,4.2626798770413155
4230,7,97,Yes,9,4,679,104,873,388,63,106,0.07142857142857142,0.09183673469387756,2.0794415416798357,4.584967478670572
4192,3,80,Yes,8,0,240,83,640,0,24,88,0.037037037037037035,0.09876543209876543,1.3862943611198906,4.394449154672439
9143,3,94,No,6,4,282,97,564,376,18,100,0.031578947368421054,0.06315789473684211,1.3862943611198906,4.553876891600541
5539,2,69,No,8,3,138,71,552,207,16,77,0.02857142857142857,0.11428571428571428,1.0986122886681098,4.248495242049359
2693,2,53,Yes,9,7,106,55,477,371,18,62,0.037037037037037035,0.16666666666666666,1.0986122886681098,3.9889840465642745
5341,2,82,No,5,3,164,84,410,246,10,87,0.024096385542168676,0.060240963855421686,1.0986122886681098,4.418840607796598
9918,4,98,Yes,9,7,392,102,882,686,36,107,0.04040404040404041,0.09090909090909091,1.6094379124341003,4.59511985013459
7671,4,87,Yes,7,0,348,91,609,0,28,94,0.045454545454545456,0.07954545454545454,1.6094379124341003,4.477336814478207
9174,5,47,No,5,2,235,52,235,94,25,52,0.10416666666666667,0.10416666666666667,1.791759469228055,3.871201010907891
1808,3,70,Yes,9,6,210,73,630,420,27,79,0.04225352112676056,0.1267605633802817,1.3862943611198906,4.2626798770413155
5112,8,82,No,9,5,656,90,738,410,72,91,0.0963855421686747,0.10843373493975904,2.1972245773362196,4.418840607796598
3990,1,95,No,8,8,95,96,760,760,8,103,0.010416666666666666,0.08333333333333333,0.6931471805599453,4.564348191467836
3456,1,92,No,9,6,92,93,828,552,9,101,0.010752688172043012,0.0967741935483871,0.6931471805599453,4.532599493153256
2908,7,79,No,5,1,553,86,395,79,35,84,0.0875,0.0625,2.0794415416798357,4.382026634673881
6652,7,51,No,8,5,357,58,408,255,56,59,0.1346153846153846,0.15384615384615385,2.0794415416798357,3.9512437185814275
8288,7,48,No,7,0,336,55,336,0,49,55,0.14285714285714285,0.14285714285714285,2.0794415416798357,3.8918202981106265
6245,7,79,Yes,9,9,553,86,711,711,63,88,0.0875,0.1125,2.0794415416798357,4.382026634673881
2698,1,42,No,4,2,42,43,168,84,4,46,0.023255813953488372,0.09302325581395349,0.6931471805599453,3.7612001156935624
4017,4,79,Yes,8,7,316,83,632,553,32,87,0.05,0.1,1.6094379124341003,4.382026634673881
4340,3,86,Yes,7,8,258,89,602,688,21,93,0.034482758620689655,0.08045977011494253,1.3862943611198906,4.465908118654584
4646,4,91,Yes,4,7,364,95,364,637,16,95,0.043478260869565216,0.043478260869565216,1.6094379124341003,4.5217885770490405
7740,7,77,No,5,6,539,84,385,462,35,82,0.08974358974358974,0.0641025641025641,2.0794415416798357,4.356708826689592
7092,2,82,Yes,7,7,164,84,574,574,14,89,0.024096385542168676,0.08433734939759036,1.0986122886681098,4.418840607796598
4693,7,54,Yes,7,7,378,61,378,378,49,61,0.12727272727272726,0.12727272727272726,2.0794415416798357,4.007333185232471
1740,4,48,No,6,3,192,52,288,144,24,54,0.08163265306122448,0.12244897959183673,1.6094379124341003,3.8918202981106265
5407,6,41,Yes,7,8,246,47,287,328,42,48,0.14285714285714285,0.16666666666666666,1.9459101490553132,3.7376696182833684
4589,2,54,No,8,8,108,56,432,432,16,62,0.03636363636363636,0.14545454545454545,1.0986122886681098,4.007333185232471
3126,2,83,No,7,4,166,85,581,332,14,90,0.023809523809523808,0.08333333333333333,1.0986122886681098,4.430816798843313
2158,4,93,Yes,5,3,372,97,465,279,20,98,0.0425531914893617,0.05319148936170213,1.6094379124341003,4.543294782270004
5334,4,48,Yes,9,6,192,52,432,288,36,57,0.08163265306122448,0.1836734693877551,1.6094379124341003,3.8918202981106265
8637,2,58,Yes,9,8,116,60,522,464,18,67,0.03389830508474576,0.15254237288135594,1.0986122886681098,4.07753744390572
1826,3,68,Yes,7,4,204,71,476,272,21,75,0.043478260869565216,0.10144927536231885,1.3862943611198906,4.23410650459726
4231,9,54,Yes,8,6,486,63,432,324,72,62,0.16363636363636364,0.14545454545454545,2.302585092994046,4.007333185232471
3488,6,51,No,5,2,306,57,255,102,30,56,0.11538461538461539,0.09615384615384616,1.9459101490553132,3.9512437185814275
9054,6,63,Yes,4,9,378,69,252,567,24,67,0.09375,0.0625,1.9459101490553132,4.1588830833596715
9769,5,84,Yes,8,3,420,89,672,252,40,92,0.058823529411764705,0.09411764705882353,1.791759469228055,4.442651256490317
3648,5,54,Yes,6,8,270,59,324,432,30,60,0.09090909090909091,0.10909090909090909,1.791759469228055,4.007333185232471
5903,4,90,Yes,8,5,360,94,720,450,32,98,0.04395604395604396,0.08791208791208792,1.6094379124341003,4.51085950651685
6386,6,62,Yes,5,4,372,68,310,248,30,67,0.09523809523809523,0.07936507936507936,1.9459101490553132,4.143134726391533
5639,5,43,No,8,0,215,48,344,0,40,51,0.11363636363636363,0.18181818181818182,1.791759469228055,3.784189633918261
6424,7,95,Yes,6,5,665,102,570,475,42,101,0.07291666666666667,0.0625,2.0794415416798357,4.564348191467836
7827,2,41,No,9,5,82,43,369,205,18,50,0.047619047619047616,0.21428571428571427,1.0986122886681098,3.7376696182833684
7744,3,65,No,5,8,195,68,325,520,15,70,0.045454545454545456,0.07575757575757576,1.3862943611198906,4.189654742026425
3013,5,79,No,5,1,395,84,395,79,25,84,0.0625,0.0625,1.791759469228055,4.382026634673881
7672,1,47,Yes,9,8,47,48,423,376,9,56,0.020833333333333332,0.1875,0.6931471805599453,3.871201010907891
9549,3,84,No,9,7,252,87,756,588,27,93,0.03529411764705882,0.10588235294117647,1.3862943611198906,4.442651256490317
9978,9,84,No,6,6,756,93,504,504,54,90,0.10588235294117647,0.07058823529411765,2.302585092994046,4.442651256490317
3081,3,73,Yes,8,7,219,76,584,511,24,81,0.04054054054054054,0.10810810810810811,1.3862943611198906,4.30406509320417
3521,6,44,No,7,6,264,50,308,264,42,51,0.13333333333333333,0.15555555555555556,1.9459101490553132,3.8066624897703196
4979,7,97,No,7,7,679,104,679,679,49,104,0.07142857142857142,0.07142857142857142,2.0794415416798357,4.584967478670572
7620,3,62,No,7,3,186,65,434,186,21,69,0.047619047619047616,0.1111111111111111,1.3862943611198906,4.143134726391533
4348,5,98,No,8,1,490,103,784,98,40,106,0.050505050505050504,0.08080808080808081,1.791759469228055,4.59511985013459
8441,1,43,Yes,8,9,43,44,344,387,8,51,0.022727272727272728,0.18181818181818182,0.6931471805599453,3.784189633918261
1347,4,45,No,5,4,180,49,225,180,20,50,0.08695652173913043,0.10869565217391304,1.6094379124341003,3.828641396489095
7088,5,72,Yes,7,4,360,77,504,288,35,79,0.0684931506849315,0.0958904109589041,1.791759469228055,4.290459441148391
8948,4,96,No,9,6,384,100,864,576,36,105,0.041237113402061855,0.09278350515463918,1.6094379124341003,4.574710978503383
5652,7,74,No,8,1,518,81,592,74,56,82,0.09333333333333334,0.10666666666666667,2.0794415416798357,4.31748811353631
8082,6,48,Yes,5,0,288,54,240,0,30,53,0.12244897959183673,0.10204081632653061,1.9459101490553132,3.8918202981106265
1792,3,72,No,4,3,216,75,288,216,12,76,0.0410958904109589,0.0547945205479452,1.3862943611198906,4.290459441148391
7429,8,73,No,9,7,584,81,657,511,72,82,0.10810810810810811,0.12162162162162163,2.1972245773362196,4.30406509320417
9580,9,69,Yes,4,9,621,78,276,621,36,73,0.12857142857142856,0.05714285714285714,2.302585092994046,4.248495242049359
9960,2,95,Yes,6,5,190,97,570,475,12,101,0.020833333333333332,0.0625,1.0986122886681098,4.564348191467836
2271,4,75,Yes,8,3,300,79,600,225,32,83,0.05263157894736842,0.10526315789473684,1.6094379124341003,4.330733340286331
9767,6,54,Yes,9,6,324,60,486,324,54,63,0.10909090909090909,0.16363636363636364,1.9459101490553132,4.007333185232471
2956,4,52,No,5,3,208,56,260,156,20,57,0.07547169811320754,0.09433962264150944,1.6094379124341003,3.970291913552122
3444,7,96,No,9,1,672,103,864,96,63,105,0.07216494845360824,0.09278350515463918,2.0794415416798357,4.574710978503383
7736,1,40,Yes,4,2,40,41,160,80,4,44,0.024390243902439025,0.0975609756097561,0.6931471805599453,3.713572066704308
834,1,86,No,7,4,86,87,602,344,7,93,0.011494252873563218,0.08045977011494253,0.6931471805599453,4.465908118654584
6499,1,88,No,9,1,88,89,792,88,9,97,0.011235955056179775,0.10112359550561797,0.6931471805599453,4.48863636973214
2992,9,55,Yes,8,5,495,64,440,275,72,63,0.16071428571428573,0.14285714285714285,2.302585092994046,4.02535169073515
7793,3,81,No,6,3,243,84,486,243,18,87,0.036585365853658534,0.07317073170731707,1.3862943611198906,4.406719247264253
2151,2,74,Yes,6,2,148,76,444,148,12,80,0.02666666666666667,0.08,1.0986122886681098,4.31748811353631
4023,6,46,No,4,0,276,52,184,0,24,50,0.1276595744680851,0.0851063829787234,1.9459101490553132,3.8501476017100584
7615,9,69,Yes,4,4,621,78,276,276,36,73,0.12857142857142856,0.05714285714285714,2.302585092994046,4.248495242049359
6124,3,92,No,9,8,276,95,828,736,27,101,0.03225806451612903,0.0967741935483871,1.3862943611198906,4.532599493153256
3339,5,53,No,9,8,265,58,477,424,45,62,0.09259259259259259,0.16666666666666666,1.791759469228055,3.9889840465642745
4344,5,88,No,6,6,440,93,528,528,30,94,0.056179775280898875,0.06741573033707865,1.791759469228055,4.48863636973214
4464,5,88,No,8,8,440,93,704,704,40,96,0.056179775280898875,0.0898876404494382,1.791759469228055,4.48863636973214
2376,3,75,No,7,2,225,78,525,150,21,82,0.039473684210526314,0.09210526315789473,1.3862943611198906,4.330733340286331
9044,7,52,No,8,1,364,59,416,52,56,60,0.1320754716981132,0.1509433962264151,2.0794415416798357,3.970291913552122
5571,4,72,No,5,9,288,76,360,648,20,77,0.0547945205479452,0.0684931506849315,1.6094379124341003,4.290459441148391
8599,9,99,Yes,5,6,891,108,495,594,45,104,0.09,0.05,2.302585092994046,4.605170185988092
8504,8,45,Yes,6,7,360,53,270,315,48,51,0.17391304347826086,0.13043478260869565,2.1972245773362196,3.828641396489095
8880,3,75,Yes,6,1,225,78,450,75,18,81,0.039473684210526314,0.07894736842105263,1.3862943611198906,4.330733340286331
1887,2,87,Yes,6,5,174,89,522,435,12,93,0.022727272727272728,0.06818181818181818,1.0986122886681098,4.477336814478207
1198,1,72,No,6,1,72,73,432,72,6,78,0.0136986301369863,0.0821917808219178,0.6931471805599453,4.290459441148391
6427,3,98,No,6,4,294,101,588,392,18,104,0.030303030303030304,0.06060606060606061,1.3862943611198906,4.59511985013459
8911,6,46,Yes,4,8,276,52,184,368,24,50,0.1276595744680851,0.0851063829787234,1.9459101490553132,3.8501476017100584
2936,7,87,No,4,6,609,94,348,522,28,91,0.07954545454545454,0.045454545454545456,2.0794415416798357,4.477336814478207
6342,9,44,No,7,9,396,53,308,396,63,51,0.2,0.15555555555555556,2.302585092994046,3.8066624897703196
1430,2,65,No,7,8,130,67,455,520,14,72,0.030303030303030304,0.10606060606060606,1.0986122886681098,4.189654742026425
6307,1,54,No,8,0,54,55,432,0,8,62,0.01818181818181818,0.14545454545454545,0.6931471805599453,4.007333185232471
3650,4,61,No,5,0,244,65,305,0,20,66,0.06451612903225806,0.08064516129032258,1.6094379124341003,4.127134385045092
1938,2,59,No,4,4,118,61,236,236,8,63,0.03333333333333333,0.06666666666666667,1.0986122886681098,4.0943445622221
5172,8,87,No,7,6,696,95,609,522,56,94,0.09090909090909091,0.07954545454545454,2.1972245773362196,4.477336814478207
7764,9,52,No,4,0,468,61,208,0,36,56,0.16981132075471697,0.07547169811320754,2.302585092994046,3.970291913552122
6393,1,57,No,6,3,57,58,342,171,6,63,0.017241379310344827,0.10344827586206896,0.6931471805599453,4.060443010546419
1154,7,94,No,9,6,658,101,846,564,63,103,0.07368421052631578,0.09473684210526316,2.0794415416798357,4.553876891600541
6250,2,78,Yes,6,3,156,80,468,234,12,84,0.02531645569620253,0.0759493670886076,1.0986122886681098,4.3694478524670215
7037,8,45,Yes,4,4,360,53,180,180,32,49,0.17391304347826086,0.08695652173913043,2.1972245773362196,3.828641396489095
4229,8,54,No,4,6,432,62,216,324,32,58,0.14545454545454545,0.07272727272727272,2.1972245773362196,4.007333185232471
4975,7,54,Yes,6,1,378,61,324,54,42,60,0.12727272727272726,0.10909090909090909,2.0794415416798357,4.007333185232471
6401,8,93,Yes,9,9,744,101,837,837,72,102,0.0851063829787234,0.09574468085106383,2.1972245773362196,4.543294782270004
3640,5,44,Yes,4,6,220,49,176,264,20,48,0.1111111111111111,0.08888888888888889,1.791759469228055,3.8066624897703196
3972,8,84,No,7,3,672,92,588,252,56,91,0.09411764705882353,0.08235294117647059,2.1972245773362196,4.442651256490317
9594,6,77,Yes,6,6,462,83,462,462,36,83,0.07692307692307693,0.07692307692307693,1.9459101490553132,4.356708826689592
3376,8,89,No,8,1,712,97,712,89,64,97,0.08888888888888889,0.08888888888888889,2.1972245773362196,4.499809670330265
2487,3,70,Yes,8,3,210,73,560,210,24,78,0.04225352112676056,0.11267605633802817,1.3862943611198906,4.2626798770413155
6954,9,47,Yes,4,0,423,56,188,0,36,51,0.1875,0.08333333333333333,2.302585092994046,3.871201010907891
606,8,62,No,5,7,496,70,310,434,40,67,0.12698412698412698,0.07936507936507936,2.1972245773362196,4.143134726391533
7444,3,56,Yes,5,9,168,59,280,504,15,61,0.05263157894736842,0.08771929824561403,1.3862943611198906,4.04305126783455
5928,3,79,Yes,4,9,237,82,316,711,12,83,0.0375,0.05,1.3862943611198906,4.382026634673881
2454,5,84,No,8,5,420,89,672,420,40,92,0.058823529411764705,0.09411764705882353,1.791759469228055,4.442651256490317
3609,2,45,Yes,4,4,90,47,180,180,8,49,0.043478260869565216,0.08695652173913043,1.0986122886681098,3.828641396489095
1484,9,52,Yes,4,1,468,61,208,52,36,56,0.16981132075471697,0.07547169811320754,2.302585092994046,3.970291913552122
4519,6,42,Yes,6,8,252,48,252,336,36,48,0.13953488372093023,0.13953488372093023,1.9459101490553132,3.7612001156935624
3038,4,68,No,8,3,272,72,544,204,32,76,0.057971014492753624,0.11594202898550725,1.6094379124341003,4.23410650459726
9352,5,99,Yes,6,4,495,104,594,396,30,105,0.05,0.06,1.791759469228055,4.605170185988092
7692,5,70,Yes,5,3,350,75,350,210,25,75,0.07042253521126761,0.07042253521126761,1.791759469228055,4.2626798770413155
4116,1,87,No,5,0,87,88,435,0,5,92,0.011363636363636364,0.056818181818181816,0.6931471805599453,4.477336814478207
1427,8,52,Yes,9,2,416,60,468,104,72,61,0.1509433962264151,0.16981132075471697,2.1972245773362196,3.970291913552122
497,9,96,No,5,9,864,105,480,864,45,101,0.09278350515463918,0.05154639175257732,2.302585092994046,4.574710978503383
3353,5,65,No,7,2,325,70,455,130,35,72,0.07575757575757576,0.10606060606060606,1.791759469228055,4.189654742026425
8794,2,80,No,6,8,160,82,480,640,12,86,0.024691358024691357,0.07407407407407407,1.0986122886681098,4.394449154672439
759,4,96,No,4,5,384,100,384,480,16,100,0.041237113402061855,0.041237113402061855,1.6094379124341003,4.574710978503383
838,1,47,No,4,5,47,48,188,235,4,51,0.020833333333333332,0.08333333333333333,0.6931471805599453,3.871201010907891
4327,5,65,Yes,6,6,325,70,390,390,30,71,0.07575757575757576,0.09090909090909091,1.791759469228055,4.189654742026425
2128,3,87,No,6,6,261,90,522,522,18,93,0.03409090909090909,0.06818181818181818,1.3862943611198906,4.477336814478207
1023,7,87,No,8,6,609,94,696,522,56,95,0.07954545454545454,0.09090909090909091,2.0794415416798357,4.477336814478207
8762,9,69,No,5,7,621,78,345,483,45,74,0.12857142857142856,0.07142857142857142,2.302585092994046,4.248495242049359
5614,2,76,No,6,6,152,78,456,456,12,82,0.025974025974025976,0.07792207792207792,1.0986122886681098,4.343805421853684
5581,6,63,Yes,9,3,378,69,567,189,54,72,0.09375,0.140625,1.9459101490553132,4.1588830833596715
1058,8,75,Yes,7,4,600,83,525,300,56,82,0.10526315789473684,0.09210526315789473,2.1972245773362196,4.330733340286331
9542,6,70,No,8,3,420,76,560,210,48,78,0.08450704225352113,0.11267605633802817,1.9459101490553132,4.2626798770413155
6856,8,65,Yes,7,1,520,73,455,65,56,72,0.12121212121212122,0.10606060606060606,2.1972245773362196,4.189654742026425
7349,9,99,Yes,8,1,891,108,792,99,72,107,0.09,0.08,2.302585092994046,4.605170185988092
9045,1,72,No,8,6,72,73,576,432,8,80,0.0136986301369863,0.1095890410958904,0.6931471805599453,4.290459441148391
2129,7,93,Yes,7,2,651,100,651,186,49,100,0.07446808510638298,0.07446808510638298,2.0794415416798357,4.543294782270004
2767,5,92,No,9,1,460,97,828,92,45,101,0.053763440860215055,0.0967741935483871,1.791759469228055,4.532599493153256
2109,7,74,Yes,6,6,518,81,444,444,42,80,0.09333333333333334,0.08,2.0794415416798357,4.31748811353631
3617,5,71,No,8,0,355,76,568,0,40,79,0.06944444444444445,0.1111111111111111,1.791759469228055,4.276666119016055
1545,2,51,No,5,0,102,53,255,0,10,56,0.038461538461538464,0.09615384615384616,1.0986122886681098,3.9512437185814275
6914,3,66,Yes,7,9,198,69,462,594,21,73,0.04477611940298507,0.1044776119402985,1.3862943611198906,4.204692619390966
1719,3,71,No,7,1,213,74,497,71,21,78,0.041666666666666664,0.09722222222222222,1.3862943611198906,4.276666119016055
7435,6,41,Yes,5,8,246,47,205,328,30,46,0.14285714285714285,0.11904761904761904,1.9459101490553132,3.7376696182833684
7365,8,70,Yes,8,1,560,78,560,70,64,78,0.11267605633802817,0.11267605633802817,2.1972245773362196,4.2626798770413155
6235,2,64,No,7,1,128,66,448,64,14,71,0.03076923076923077,0.1076923076923077,1.0986122886681098,4.174387269895637
725,2,95,No,9,7,190,97,855,665,18,104,0.020833333333333332,0.09375,1.0986122886681098,4.564348191467836
6673,1,89,No,8,8,89,90,712,712,8,97,0.011111111111111112,0.08888888888888889,0.6931471805599453,4.499809670330265
8029,7,93,Yes,9,8,651,100,837,744,63,102,0.07446808510638298,0.09574468085106383,2.0794415416798357,4.543294782270004
5492,1,54,No,7,3,54,55,378,162,7,61,0.01818181818181818,0.12727272727272726,0.6931471805599453,4.007333185232471
1128,8,76,Yes,5,4,608,84,380,304,40,81,0.1038961038961039,0.06493506493506493,2.1972245773362196,4.343805421853684
2957,4,65,No,4,1,260,69,260,65,16,69,0.06060606060606061,0.06060606060606061,1.6094379124341003,4.189654742026425
5156,7,65,Yes,5,1,455,72,325,65,35,70,0.10606060606060606,0.07575757575757576,2.0794415416798357,4.189654742026425
4817,6,66,Yes,4,2,396,72,264,132,24,70,0.08955223880597014,0.05970149253731343,1.9459101490553132,4.204692619390966
6202,5,87,No,6,9,435,92,522,783,30,93,0.056818181818181816,0.06818181818181818,1.791759469228055,4.477336814478207
6224,2,77,Yes,6,7,154,79,462,539,12,83,0.02564102564102564,0.07692307692307693,1.0986122886681098,4.356708826689592
8686,6,54,Yes,5,6,324,60,270,324,30,59,0.10909090909090909,0.09090909090909091,1.9459101490553132,4.007333185232471
7114,8,88,Yes,7,5,704,96,616,440,56,95,0.0898876404494382,0.07865168539325842,2.1972245773362196,4.48863636973214
5275,2,66,No,7,4,132,68,462,264,14,73,0.029850746268656716,0.1044776119402985,1.0986122886681098,4.204692619390966
8536,6,64,Yes,6,9,384,70,384,576,36,70,0.09230769230769231,0.09230769230769231,1.9459101490553132,4.174387269895637
3044,8,80,Yes,5,9,640,88,400,720,40,85,0.09876543209876543,0.06172839506172839,2.1972245773362196,4.394449154672439
6912,4,61,Yes,4,4,244,65,244,244,16,65,0.06451612903225806,0.06451612903225806,1.6094379124341003,4.127134385045092
150,4,77,Yes,8,6,308,81,616,462,32,85,0.05128205128205128,0.10256410256410256,1.6094379124341003,4.356708826689592
7574,4,62,No,7,4,248,66,434,248,28,69,0.06349206349206349,0.1111111111111111,1.6094379124341003,4.143134726391533
4206,6,54,No,8,1,324,60,432,54,48,62,0.10909090909090909,0.14545454545454545,1.9459101490553132,4.007333185232471
5493,3,54,Yes,6,0,162,57,324,0,18,60,0.05454545454545454,0.10909090909090909,1.3862943611198906,4.007333185232471
2690,4,94,Yes,4,3,376,98,376,282,16,98,0.042105263157894736,0.042105263157894736,1.6094379124341003,4.553876891600541
4221,1,79,Yes,7,3,79,80,553,237,7,86,0.0125,0.0875,0.6931471805599453,4.382026634673881
9102,4,51,Yes,9,5,204,55,459,255,36,60,0.07692307692307693,0.17307692307692307,1.6094379124341003,3.9512437185814275
842,5,82,No,8,3,410,87,656,246,40,90,0.060240963855421686,0.0963855421686747,1.791759469228055,4.418840607796598
8137,9,47,No,5,7,423,56,235,329,45,52,0.1875,0.10416666666666667,2.302585092994046,3.871201010907891
6438,5,93,No,4,2,465,98,372,186,20,97,0.05319148936170213,0.0425531914893617,1.791759469228055,4.543294782270004
9700,7,78,No,6,5,546,85,468,390,42,84,0.08860759493670886,0.0759493670886076,2.0794415416798357,4.3694478524670215
6200,5,42,Yes,7,3,210,47,294,126,35,49,0.11627906976744186,0.16279069767441862,1.791759469228055,3.7612001156935624
2795,5,57,Yes,5,3,285,62,285,171,25,62,0.08620689655172414,0.08620689655172414,1.791759469228055,4.060443010546419
7626,7,77,No,8,3,539,84,616,231,56,85,0.08974358974358974,0.10256410256410256,2.0794415416798357,4.356708826689592
8475,8,57,No,5,3,456,65,285,171,40,62,0.13793103448275862,0.08620689655172414,2.1972245773362196,4.060443010546419
7890,3,62,Yes,6,6,186,65,372,372,18,68,0.047619047619047616,0.09523809523809523,1.3862943611198906,4.143134726391533
6608,3,65,Yes,8,0,195,68,520,0,24,73,0.045454545454545456,0.12121212121212122,1.3862943611198906,4.189654742026425
9195,1,75,Yes,4,1,75,76,300,75,4,79,0.013157894736842105,0.05263157894736842,0.6931471805599453,4.330733340286331
8248,6,64,Yes,7,4,384,70,448,256,42,71,0.09230769230769231,0.1076923076923077,1.9459101490553132,4.174387269895637
1393,3,66,No,7,3,198,69,462,198,21,73,0.04477611940298507,0.1044776119402985,1.3862943611198906,4.204692619390966
1922,3,93,No,8,4,279,96,744,372,24,101,0.031914893617021274,0.0851063829787234,1.3862943611198906,4.543294782270004
7019,5,59,No,4,1,295,64,236,59,20,63,0.08333333333333333,0.06666666666666667,1.791759469228055,4.0943445622221
3622,4,69,No,7,2,276,73,483,138,28,76,0.05714285714285714,0.1,1.6094379124341003,4.248495242049359
4849,6,86,No,7,7,516,92,602,602,42,93,0.06896551724137931,0.08045977011494253,1.9459101490553132,4.465908118654584
2292,7,52,No,4,4,364,59,208,208,28,56,0.1320754716981132,0.07547169811320754,2.0794415416798357,3.970291913552122
2134,8,64,No,9,0,512,72,576,0,72,73,0.12307692307692308,0.13846153846153847,2.1972245773362196,4.174387269895637
551,4,95,Yes,6,2,380,99,570,190,24,101,0.041666666666666664,0.0625,1.6094379124341003,4.564348191467836
1741,6,61,No,5,2,366,67,305,122,30,66,0.0967741935483871,0.08064516129032258,1.9459101490553132,4.127134385045092
5290,5,52,No,8,1,260,57,416,52,40,60,0.09433962264150944,0.1509433962264151,1.791759469228055,3.970291913552122
1818,5,66,Yes,4,3,330,71,264,198,20,70,0.07462686567164178,0.05970149253731343,1.791759469228055,4.204692619390966
4699,3,91,Yes,8,8,273,94,728,728,24,99,0.03260869565217391,0.08695652173913043,1.3862943611198906,4.5217885770490405
5182,4,79,No,5,4,316,83,395,316,20,84,0.05,0.0625,1.6094379124341003,4.382026634673881
3019,9,50,No,6,3,450,59,300,150,54,56,0.17647058823529413,0.11764705882352941,2.302585092994046,3.9318256327243257
18,6,83,Yes,7,2,498,89,581,166,42,90,0.07142857142857142,0.08333333333333333,1.9459101490553132,4.430816798843313
1771,2,78,Yes,8,8,156,80,624,624,16,86,0.02531645569620253,0.10126582278481013,1.0986122886681098,4.3694478524670215
1889,6,75,Yes,4,1,450,81,300,75,24,79,0.07894736842105263,0.05263157894736842,1.9459101490553132,4.330733340286331
2153,5,94,Yes,8,9,470,99,752,846,40,102,0.05263157894736842,0.08421052631578947,1.791759469228055,4.553876891600541
1643,1,40,No,8,5,40,41,320,200,8,48,0.024390243902439025,0.1951219512195122,0.6931471805599453,3.713572066704308
7847,6,77,No,7,0,462,83,539,0,42,84,0.07692307692307693,0.08974358974358974,1.9459101490553132,4.356708826689592
4194,1,55,No,7,3,55,56,385,165,7,62,0.017857142857142856,0.125,0.6931471805599453,4.02535169073515
9433,8,89,Yes,4,1,712,97,356,89,32,93,0.08888888888888889,0.044444444444444446,2.1972245773362196,4.499809670330265
8899,7,49,Yes,6,4,343,56,294,196,42,55,0.14,0.12,2.0794415416798357,3.912023005428146
534,1,71,No,7,9,71,72,497,639,7,78,0.013888888888888888,0.09722222222222222,0.6931471805599453,4.276666119016055
133,4,54,No,7,5,216,58,378,270,28,61,0.07272727272727272,0.12727272727272726,1.6094379124341003,4.007333185232471
7723,9,91,Yes,5,2,819,100,455,182,45,96,0.09782608695652174,0.05434782608695652,2.302585092994046,4.5217885770490405
8459,3,52,Yes,5,4,156,55,260,208,15,57,0.05660377358490566,0.09433962264150944,1.3862943611198906,3.970291913552122
965,1,45,No,7,2,45,46,315,90,7,52,0.021739130434782608,0.15217391304347827,0.6931471805599453,3.828641396489095
8720,9,55,Yes,6,1,495,64,330,55,54,61,0.16071428571428573,0.10714285714285714,2.302585092994046,4.02535169073515
6413,2,70,No,7,3,140,72,490,210,14,77,0.028169014084507043,0.09859154929577464,1.0986122886681098,4.2626798770413155
8286,4,79,No,9,3,316,83,711,237,36,88,0.05,0.1125,1.6094379124341003,4.382026634673881
7854,2,40,Yes,7,2,80,42,280,80,14,47,0.04878048780487805,0.17073170731707318,1.0986122886681098,3.713572066704308
1096,3,83,No,7,5,249,86,581,415,21,90,0.03571428571428571,0.08333333333333333,1.3862943611198906,4.430816798843313
6930,5,60,No,8,4,300,65,480,240,40,68,0.08196721311475409,0.13114754098360656,1.791759469228055,4.110873864173311
